"aY" = (/obj/structure/torchwall/service{pixel_y = 32},/turf/simulated/open,/area/warfare)
"fs" = (/turf/simulated/floor/plating/n2floor,/area/warfare)
"iw" = (/obj/structure/grille/floorgrille,/turf/simulated/open,/area/warfare)
"mW" = (/obj/structure/torchwall/service{dir = 1},/turf/simulated/open,/area/warfare)
"wk" = (/obj/structure/stairs/south,/turf/simulated/floor/tiled,/area/warfare)
"yn" = (/turf/simulated/wall/concrete,/area/warfare)
"zj" = (/obj/structure/torchwall/service{dir = 8},/obj/effect/floor_decal/turf/plating,/turf/simulated/floor/tiled,/area/warfare)
"zH" = (/turf/simulated/floor/plating/reinforced,/area/warfare)
"Bi" = (/obj/structure/stairs/north,/turf/simulated/open,/area/warfare)
"Lq" = (/obj/effect/floor_decal/turf/plating,/turf/simulated/floor/tiled,/area/warfare)
"Nn" = (/turf/simulated/floor/trenches,/area/warfare)
"RZ" = (/turf/simulated/floor/dirty/indestructable,/area/warfare)
"TH" = (/turf/simulated/floor/tiled,/area/warfare)
"Ve" = (/obj/structure/torchwall/service{dir = 4},/obj/effect/floor_decal/turf/plating,/turf/simulated/floor/tiled,/area/warfare)
"Zt" = (/turf/simulated/open,/area/warfare)

(1,1,1) = {"
ZtZtZtZtZtZtZtZtZtZtZtZtZtZtZtZtZtZtZtZtZtZtZtZtZtZtZtZtZtZtZtZtZtZtZtZtZtZtZtZtZtZtZtZtZtZtZtZtZtZtZtZtZtZtZtZtZtZtZtZtZtZtZtZtZtZtZtZtZtZtZtZtZtZtZtZtZtZtZtZtZtZtZtZtZtZtZtZtZtZtZtZtZtZtZtZtZtZtZtZt
ZtZtZtZtZtZtZtZtZtZtZtZtZtZtZtZtZtZtZtZtZtZtZtZtZtZtZtZtZtZtZtZtZtZtZtZtZtZtZtZtZtZtZtZtZtZtZtZtZtZtZtZtZtZtZtZtZtZtZtZtZtZtZtZtZtZtZtZtZtZtZtZtZtZtZtZtZtZtZtZtZtZtZtZtZtZtZtZtZtZtZtZtZtZtZtZtZtZtZtZt
ZtZtZtZtZtZtZtZtZtZtZtZtZtZtZtZtZtZtZtZtZtZtZtZtZtZtZtZtZtZtZtZtZtZtZtZtZtZtZtZtZtZtZtZtZtZtZtZtZtZtZtZtZtZtZtZtZtZtZtZtZtZtZtZtZtZtZtZtZtZtZtZtZtZtZtZtZtZtZtZtZtZtZtZtZtZtZtZtZtZtZtZtZtZtZtZtZtZtZtZt
ZtZtZtZtZtZtZtZtZtZtZtZtZtZtZtZtZtZtZtZtZtZtZtZtZtZtZtZtZtZtZtZtZtZtZtZtZtZtZtZtZtZtZtZtZtZtZtZtZtZtZtZtZtZtZtZtZtZtZtZtZtZtZtZtZtZtZtZtZtZtZtZtZtZtZtZtZtZtZtZtZtZtZtZtZtZtZtZtZtZtZtZtZtZtZtZtZtZtZtZt
ZtZtZtZtZtZtZtZtZtZtZtZtZtZtZtZtZtZtZtZtZtZtZtZtZtZtZtZtZtZtZtZtZtZtZtZtZtZtZtZtZtZtZtZtZtZtZtZtZtZtZtZtZtZtZtZtZtZtZtZtZtZtZtZtZtZtZtZtZtZtZtZtZtZtZtZtZtZtZtZtZtZtZtZtZtZtZtZtZtZtZtZtZtZtZtZtZtZtZtZt
ZtZtZtZtZtZtZtZtZtZtZtZtZtZtZtZtZtZtZtZtZtZtZtZtZtZtZtZtZtZtZtZtZtZtZtZtZtZtZtZtZtZtZtZtZtZtZtZtZtZtZtZtZtZtZtZtZtZtZtZtZtZtZtZtZtZtZtZtZtZtZtZtZtZtZtZtZtZtZtZtZtZtZtZtZtZtZtZtZtZtZtZtZtZtZtZtZtZtZtZt
ZtZtZtZtZtZtZtZtZtZtZtZtZtZtZtZtZtZtZtZtZtZtZtZtZtZtZtZtZtZtZtZtZtZtZtZtZtZtZtZtZtZtZtZtZtZtZtZtZtZtZtZtZtZtZtZtZtZtZtZtZtZtZtZtZtZtZtZtZtZtZtZtZtZtZtZtZtZtZtZtZtZtZtZtZtZtZtZtZtZtZtZtZtZtZtZtZtZtZtZt
ZtZtZtZtZtZtZtZtZtZtZtZtZtZtZtZtZtZtZtZtZtZtZtZtZtZtZtZtZtZtZtZtZtZtZtZtZtZtZtZtZtZtZtZtZtZtZtZtZtZtZtZtZtZtZtZtZtZtZtZtZtZtZtZtZtZtZtZtZtZtZtZtZtZtZtZtZtZtZtZtZtZtZtZtZtZtZtZtZtZtZtZtZtZtZtZtZtZtZtZt
ZtZtZtZtZtZtZtZtZtZtZtZtZtZtZtZtZtZtZtZtZtZtZtZtZtZtZtZtZtZtZtZtZtZtZtZtZtZtZtZtZtZtZtZtZtZtZtZtZtZtZtZtZtZtZtZtZtZtZtZtZtZtZtZtZtZtZtZtZtZtZtZtZtZtZtZtZtZtZtZtZtZtZtZtZtZtZtZtZtZtZtZtZtZtZtZtZtZtZtZt
ZtZtZtZtZtZtZtZtZtZtZtZtZtZtZtZtZtZtZtZtZtZtZtZtZtZtZtZtZtZtZtZtZtZtZtZtZtZtZtZtZtZtZtZtZtZtZtZtZtZtZtZtZtZtZtZtZtZtZtZtZtZtZtZtZtZtZtZtZtZtZtZtZtZtZtZtZtZtZtZtZtZtZtZtZtZtZtZtZtZtZtZtZtZtZtZtZtZtZtZt
ZtZtZtZtZtZtZtZtZtZtZtZtZtZtZtZtZtZtZtZtZtZtZtZtZtZtZtZtZtZtZtZtZtZtZtZtZtZtZtZtZtZtZtZtZtZtZtZtZtZtZtZtZtZtZtZtZtZtZtZtZtZtZtZtZtZtZtZtZtZtZtZtZtZtZtZtZtZtZtZtZtZtZtZtZtZtZtZtZtZtZtZtZtZtZtZtZtZtZtZt
ZtZtZtZtZtZtZtZtZtZtZtZtZtZtZtZtZtZtZtZtZtZtZtZtZtZtZtZtZtZtZtZtZtZtZtZtZtZtZtZtZtZtZtZtZtZtZtZtZtZtZtZtZtZtZtZtZtZtZtZtZtZtZtZtZtZtZtZtZtZtZtZtZtZtZtZtZtZtZtZtZtZtZtZtZtZtZtZtZtZtZtZtZtZtZtZtZtZtZtZt
ZtZtZtZtZtZtZtZtZtZtZtZtZtZtZtZtZtZtZtZtZtZtZtZtZtZtZtZtZtZtZtZtZtZtZtZtZtZtZtZtZtZtZtZtZtZtZtZtZtZtZtZtZtZtZtZtZtZtZtZtZtZtZtZtZtZtZtZtZtZtZtZtZtZtZtZtZtZtZtZtZtZtZtZtZtZtZtZtZtZtZtZtZtZtZtZtZtZtZtZt
ZtZtZtZtZtZtZtZtZtZtZtZtZtZtZtZtZtZtZtZtZtZtZtZtZtZtZtZtZtZtZtZtZtZtZtZtZtZtZtZtZtZtZtZtZtZtZtZtZtZtZtZtZtZtZtZtZtZtZtZtZtZtZtZtZtZtZtZtZtZtZtZtZtZtZtZtZtZtZtZtZtZtZtZtZtZtZtZtZtZtZtZtZtZtZtZtZtZtZtZt
ZtZtZtZtZtZtZtZtZtZtZtZtZtZtZtZtZtZtZtZtZtZtZtZtZtZtZtZtZtZtZtZtZtZtZtZtZtZtZtZtZtZtZtZtZtZtZtZtZtZtZtZtZtZtZtZtZtZtZtZtZtZtZtZtZtZtZtZtZtZtZtZtZtZtZtZtZtZtZtZtZtZtZtZtZtZtZtZtZtZtZtZtZtZtZtZtZtZtZtZt
ZtZtZtZtZtZtZtZtZtZtZtZtZtZtZtZtZtZtZtZtZtZtZtZtZtZtZtZtZtZtZtZtZtZtZtZtZtZtZtZtZtZtZtZtZtZtZtZtZtZtZtZtZtZtZtZtZtZtZtZtZtZtZtZtZtZtZtZtZtZtZtZtZtZtZtZtZtZtZtZtZtZtZtZtZtZtZtZtZtZtZtZtZtZtZtZtZtZtZtZt
ZtZtZtZtZtZtZtZtZtZtZtZtZtZtZtZtZtZtZtZtZtZtZtZtZtZtZtZtZtZtZtZtZtZtZtZtZtZtZtZtZtZtZtZtZtZtZtZtZtZtZtZtZtZtZtZtZtZtZtZtZtZtZtZtZtZtZtZtZtZtZtZtZtZtZtZtZtZtZtZtZtZtZtZtZtZtZtZtZtZtZtZtZtZtZtZtZtZtZtZt
ZtZtZtZtZtZtZtZtZtZtZtZtZtZtZtZtZtZtZtZtZtZtZtZtZtZtZtZtZtZtZtZtZtZtZtZtZtZtZtZtZtZtZtZtZtZtZtZtZtZtZtZtZtZtZtZtZtZtZtZtZtZtZtZtZtZtZtZtZtZtZtZtZtZtZtZtZtZtZtZtZtZtZtZtZtZtZtZtZtZtZtZtZtZtZtZtZtZtZtZt
ZtZtZtZtZtZtZtZtZtZtZtZtZtZtZtZtZtZtZtZtZtZtZtZtZtZtZtZtZtZtZtZtZtZtZtZtZtZtZtZtZtZtZtZtZtZtZtZtZtZtZtZtZtZtZtZtZtZtZtZtZtZtZtZtZtZtZtZtZtZtZtZtZtZtZtZtZtZtZtZtZtZtZtZtZtZtZtZtZtZtZtZtZtZtZtZtZtZtZtZt
ZtZtZtZtZtZtZtZtZtZtZtZtZtZtZtZtZtZtZtZtZtZtZtZtZtZtZtZtZtZtZtZtZtZtZtZtZtZtZtZtZtZtZtZtZtZtZtZtZtZtZtZtZtZtZtZtZtZtZtZtZtZtZtZtZtZtZtZtZtZtZtZtZtZtZtZtZtZtZtZtZtZtZtZtZtZtZtZtZtZtZtZtZtZtZtZtZtZtZtZt
ZtZtZtZtZtZtZtZtZtZtZtZtZtZtZtZtZtZtZtZtZtZtZtZtZtZtZtZtZtZtZtZtZtZtZtZtZtZtZtZtZtZtZtZtZtZtZtZtZtZtZtZtZtZtZtZtZtZtZtZtZtZtZtZtZtZtZtZtZtZtZtZtZtZtZtZtZtZtZtZtZtZtZtZtZtZtZtZtZtZtZtZtZtZtZtZtZtZtZtZt
ZtZtZtZtZtZtZtZtZtZtZtZtZtZtZtZtZtZtZtZtZtZtZtZtZtZtZtZtZtZtZtZtZtZtZtZtZtZtZtZtZtZtZtZtZtZtZtZtZtZtZtZtZtZtZtZtZtZtZtZtZtZtZtZtZtZtZtZtZtZtZtZtZtZtZtZtZtZtZtZtZtZtZtZtZtZtZtZtZtZtZtZtZtZtZtZtZtZtZtZt
ZtZtZtZtZtZtZtZtZtZtZtZtZtZtZtZtZtZtZtZtZtZtZtZtZtZtZtZtZtZtZtZtZtZtZtZtZtZtZtZtZtZtZtZtZtZtZtZtZtZtZtZtZtZtZtZtZtZtZtZtZtZtZtZtZtZtZtZtZtZtZtZtZtZtZtZtZtZtZtZtZtZtZtZtZtZtZtZtZtZtZtZtZtZtZtZtZtZtZtZt
ZtZtZtZtZtZtZtZtZtZtZtZtZtZtZtZtZtZtZtZtZtZtZtZtZtZtZtZtZtZtZtZtZtZtZtZtZtZtZtZtZtZtZtZtZtZtZtZtZtZtZtZtZtZtZtZtZtZtZtZtZtZtZtZtZtZtZtZtZtZtZtZtZtZtZtZtZtZtZtZtZtZtZtZtZtZtZtZtZtZtZtZtZtZtZtZtZtZtZtZt
ZtZtZtZtZtZtZtZtZtZtZtZtZtZtZtZtZtZtZtZtZtZtZtZtZtZtZtZtZtZtZtZtZtZtZtZtZtZtZtZtZtZtZtZtZtZtZtZtZtZtZtZtZtZtZtZtZtZtZtZtZtZtZtZtZtZtZtZtZtZtZtZtZtZtZtZtZtZtZtZtZtZtZtZtZtZtZtZtZtZtZtZtZtZtZtZtZtZtZtZt
ZtZtZtZtZtZtZtZtZtZtZtZtZtZtZtZtZtZtZtZtZtZtZtZtZtZtZtZtZtZtZtZtZtZtZtZtZtZtZtZtZtZtZtZtZtZtZtZtZtZtZtZtZtZtZtZtZtZtZtZtZtZtZtZtZtZtZtZtZtZtZtZtZtZtZtZtZtZtZtZtZtZtZtZtZtZtZtZtZtZtZtZtZtZtZtZtZtZtZtZt
ZtZtZtZtZtZtZtZtZtZtZtZtZtZtZtZtZtZtZtZtZtZtZtZtZtZtZtZtZtZtZtZtZtZtZtZtZtZtZtZtZtZtZtZtZtZtZtZtZtZtZtZtZtZtZtZtZtZtZtZtZtZtZtZtZtZtZtZtZtZtZtZtZtZtZtZtZtZtZtZtZtZtZtZtZtZtZtZtZtZtZtZtZtZtZtZtZtZtZtZt
ZtZtZtZtZtZtZtZtZtZtZtZtZtZtZtZtZtZtZtZtZtZtZtZtZtZtZtZtZtZtZtZtZtZtZtZtZtZtZtZtZtZtZtZtZtZtZtZtZtZtZtZtZtZtZtZtZtZtZtZtZtZtZtZtZtZtZtZtZtZtZtZtZtZtZtZtZtZtZtZtZtZtZtZtZtZtZtZtZtZtZtZtZtZtZtZtZtZtZtZt
ZtZtZtZtZtZtZtZtZtZtZtZtZtZtZtZtZtZtZtZtZtZtZtZtZtZtZtZtZtZtZtZtZtZtZtZtZtZtZtZtZtZtZtZtZtZtZtZtZtZtZtZtZtZtZtZtZtZtZtZtZtZtZtZtZtZtZtZtZtZtZtZtZtZtZtZtZtZtZtZtZtZtZtZtZtZtZtZtZtZtZtZtZtZtZtZtZtZtZtZt
ZtZtZtZtZtZtZtZtZtZtZtZtZtZtZtZtZtZtZtZtZtZtZtZtZtZtZtZtZtZtZtZtZtZtZtZtZtZtZtZtZtZtZtZtZtZtZtZtZtZtZtZtZtZtZtZtZtZtZtZtZtZtZtZtZtZtZtZtZtZtZtZtZtZtZtZtZtZtZtZtZtZtZtZtZtZtZtZtZtZtZtZtZtZtZtZtZtZtZtZt
ZtZtZtZtZtZtZtZtZtZtZtZtZtZtZtZtZtZtZtZtZtZtZtZtZtZtZtZtZtZtZtZtZtZtZtZtZtZtZtZtZtZtZtZtZtZtZtZtZtZtZtZtZtZtZtZtZtZtZtZtZtZtZtZtZtZtZtZtZtZtZtZtZtZtZtZtZtZtZtZtZtZtZtZtZtZtZtZtZtZtZtZtZtZtZtZtZtZtZtZt
ZtZtZtZtZtZtZtZtZtZtZtZtZtZtZtZtZtZtZtZtZtZtZtZtZtZtZtZtZtZtZtZtZtZtZtZtZtZtZtZtZtZtZtZtZtZtZtZtZtZtZtZtZtZtZtZtZtZtZtZtZtZtZtZtZtZtZtZtZtZtZtZtZtZtZtZtZtZtZtZtZtZtZtZtZtZtZtZtZtZtZtZtZtZtZtZtZtZtZtZt
ZtZtZtZtZtZtZtZtZtZtZtZtZtZtZtZtZtZtZtZtZtZtZtZtZtZtZtZtZtZtZtZtZtZtZtZtZtZtZtZtZtZtZtZtZtZtZtZtZtZtZtZtZtZtZtZtZtZtZtZtZtZtZtZtZtZtZtZtZtZtZtZtZtZtZtZtZtZtZtZtZtZtZtZtZtZtZtZtZtZtZtZtZtZtZtZtZtZtZtZt
ZtZtZtZtZtZtZtZtZtZtZtZtZtZtZtZtZtZtZtZtZtZtZtZtZtZtZtZtZtZtZtZtZtZtZtZtZtZtZtZtZtZtZtZtZtZtZtZtZtZtZtZtZtZtZtZtZtZtZtZtZtZtZtZtZtZtZtZtZtZtZtZtZtZtZtZtZtZtZtZtZtZtZtZtZtZtZtZtZtZtZtZtZtZtZtZtZtZtZtZt
ZtZtZtZtZtZtZtZtZtZtZtZtZtZtZtZtZtZtZtZtZtZtZtZtZtZtZtZtZtZtZtZtZtZtZtZtZtZtZtZtZtZtZtZtZtZtZtZtZtZtZtZtZtZtZtZtZtZtZtZtZtZtZtZtZtZtZtZtZtZtZtZtZtZtZtZtZtZtZtZtZtZtZtZtZtZtZtZtZtZtZtZtZtZtZtZtZtZtZtZt
ZtZtZtZtZtZtZtZtZtZtZtZtZtZtZtZtZtZtZtZtZtZtZtZtZtZtZtZtZtZtZtZtZtZtZtZtZtZtZtZtZtZtZtZtZtZtZtynynynynynZtZtZtZtZtZtZtZtZtZtZtZtZtZtZtZtZtZtZtZtZtZtZtZtZtZtZtZtZtZtZtZtZtZtZtZtZtZtZtZtZtZtZtZtZtZtZtZt
ZtZtZtZtZtZtZtZtZtZtZtZtZtZtZtZtZtZtZtZtZtZtZtZtZtZtZtZtZtZtZtZtZtZtZtZtZtZtZtZtZtZtZtZtZtynynynTHTHTHynynynZtZtZtZtZtZtZtZtZtZtZtZtZtZtZtZtZtZtZtZtZtZtZtZtZtZtZtZtZtZtZtZtZtZtZtZtZtZtZtZtZtZtZtZtZtZt
ZtZtZtZtZtZtZtZtZtZtZtZtZtZtZtZtZtZtZtZtZtZtZtZtZtZtZtZtZtZtZtZtZtZtZtZtZtZtZtZtZtZtZtZtynynTHTHTHTHTHTHTHynynZtZtZtZtZtZtZtZtZtZtZtZtZtZtZtZtZtZtZtZtZtZtZtZtZtZtZtZtZtZtZtZtZtZtZtZtZtZtZtZtZtZtZtZtZt
ZtZtZtZtZtZtZtZtZtZtZtZtZtZtZtZtZtZtZtZtZtZtZtZtZtZtZtZtZtZtZtZtZtZtZtZtZtZtZtZtZtZtZtZtynTHTHTHTHTHTHTHTHTHynZtZtZtZtZtZtZtZtZtZtZtZtZtZtZtZtZtZtZtZtZtZtZtZtZtZtZtZtZtZtZtZtZtZtZtZtZtZtZtZtZtZtZtZtZt
ZtZtZtZtZtZtZtZtZtZtZtZtZtZtZtZtZtZtZtZtZtZtZtZtZtZtZtZtZtZtZtZtZtZtZtZtZtZtZtZtZtZtZtZtynTHTHTHTHTHTHTHTHTHynZtZtZtZtZtZtZtZtZtZtZtZtZtZtZtZtZtZtZtZtZtZtZtZtZtZtZtZtZtZtZtZtZtZtZtZtZtZtZtZtZtZtZtZtZt
ZtZtZtZtZtZtZtZtZtZtZtZtZtZtZtZtZtZtZtZtZtZtZtZtZtZtZtZtZtZtZtZtZtZtZtZtZtZtZtZtZtZtZtZtynTHTHzHzHzHzHzHTHTHynZtZtZtZtZtZtZtZtZtZtZtZtZtZtZtZtZtZtZtZtZtZtZtZtZtZtZtZtZtZtZtZtZtZtZtZtZtZtZtZtZtZtZtZtZt
ZtZtZtZtZtZtZtZtZtZtZtZtZtZtZtZtZtZtZtZtZtZtZtZtZtZtZtZtZtZtZtZtZtZtZtZtZtZtZtZtynynynynynTHTHynNnzHNnynTHTHynynynynynZtZtZtZtZtZtZtZtZtZtZtZtZtZtZtZtZtZtZtZtZtZtZtZtZtZtZtZtZtZtZtZtZtZtZtZtZtZtZtZtZt
ZtZtZtZtZtZtZtZtZtZtZtZtZtZtZtZtZtZtZtZtZtZtZtZtZtZtZtZtZtZtZtZtZtZtZtZtZtZtZtZtynfsfsfsfsTHTHynNnNnNnynTHTHfsfsfsfsynZtZtZtZtZtZtZtZtZtZtZtZtZtZtZtZtZtZtZtZtZtZtZtZtZtZtZtZtZtZtZtZtZtZtZtZtZtZtZtZtZt
ZtZtZtZtZtZtZtZtZtZtZtZtZtZtZtZtZtZtZtZtZtZtZtZtZtZtZtZtZtZtZtZtZtZtZtZtZtZtZtZtynfsynynynTHTHynNnNnNnynTHTHynynynfsynZtZtZtZtZtZtZtZtZtZtZtZtZtZtZtZtZtZtZtZtZtZtZtZtZtZtZtZtZtZtZtZtZtZtZtZtZtZtZtZtZt
ZtZtZtZtZtZtZtZtZtZtZtZtZtZtZtZtZtZtZtZtZtZtZtZtZtZtZtZtZtZtZtZtZtZtZtZtZtZtZtZtynfsyniwynwkwkynZtZtZtynwkwkyniwynfsynZtZtZtZtZtZtZtZtZtZtZtZtZtZtZtZtZtZtZtZtZtZtZtZtZtZtZtZtZtZtZtZtZtZtZtZtZtZtZtZtZt
ZtZtZtZtZtZtZtZtZtZtZtZtZtZtZtZtZtZtZtZtZtZtZtZtZtZtZtZtZtZtZtZtZtZtZtZtZtZtZtZtynfsynfsynynynynZtZtZtynynynynfsynfsynZtZtZtZtZtZtZtZtZtZtZtZtZtZtZtZtZtZtZtZtZtZtZtZtZtZtZtZtZtZtZtZtZtZtZtZtZtZtZtZtZt
ZtZtZtZtZtZtZtZtZtZtZtZtZtZtZtZtZtZtZtZtZtZtZtZtZtZtZtZtZtZtZtZtZtZtZtZtZtZtZtZtynfsynfsynynLqLqLqZtLqLqLqynynfsynfsynZtZtZtZtZtZtZtZtZtZtZtZtZtZtZtZtZtZtZtZtZtZtZtZtZtZtZtZtZtZtZtZtZtZtZtZtZtZtZtZtZt
ZtZtZtZtZtZtZtZtZtZtZtZtZtZtZtZtZtZtZtZtZtZtZtZtZtZtZtZtZtZtZtZtZtZtZtZtynynynynynfsynfsynLqLqZtZtZtZtZtLqLqynfsynfsynynynynynZtZtZtZtZtZtZtZtZtZtZtZtZtZtZtZtZtZtZtZtZtZtZtZtZtZtZtZtZtZtZtZtZtZtZtZtZt
ZtZtZtZtZtZtZtZtZtZtZtZtZtZtZtZtZtZtZtZtZtZtZtZtZtZtZtZtZtZtZtZtZtZtZtZtynfsfsfsfsfsynfsynZtZtZtZtmWZtZtZtZtynfsynfsfsfsfsfsynZtZtZtZtZtZtZtZtZtZtZtZtZtZtZtZtZtZtZtZtZtZtZtZtZtZtZtZtZtZtZtZtZtZtZtZtZt
ZtZtZtZtZtZtZtZtZtZtZtZtZtZtZtZtZtZtZtZtZtZtZtZtZtZtZtZtZtZtZtZtZtZtZtZtynfsynynynynynfsynVeZtZtLqynLqZtZtynynfsynynynynynfsynZtZtZtZtZtZtZtZtZtZtZtZtZtZtZtZtZtZtZtZtZtZtZtZtZtZtZtZtZtZtZtZtZtZtZtZtZt
ZtZtZtZtZtZtZtZtZtZtZtZtZtZtZtZtZtZtZtZtZtZtZtZtZtZtZtZtZtZtZtZtZtZtZtZtynTHTHTHTHyniwfsfsLqZtZtZtynZtZtZtLqfsfsiwynTHTHTHTHynZtZtZtZtZtZtZtZtZtZtZtZtZtZtZtZtZtZtZtZtZtZtZtZtZtZtZtZtZtZtZtZtZtZtZtZtZt
ZtZtZtZtZtZtZtZtZtZtZtZtZtZtZtZtZtZtZtZtZtZtZtZtZtZtZtZtZtZtZtZtZtZtZtZtynTHTHTHTHynynfsynynZtZtLqynLqZtZtzjynfsynynTHTHTHTHynZtZtZtZtZtZtZtZtZtZtZtZtZtZtZtZtZtZtZtZtZtZtZtZtZtZtZtZtZtZtZtZtZtZtZtZtZt
ZtZtZtZtZtZtZtZtZtZtZtZtZtZtZtZtZtZtZtZtZtZtZtZtZtZtZtZtZtZtZtZtZtZtZtZtynTHTHTHTHTHynfsynZtZtZtZtaYZtZtZtZtynfsynTHTHTHTHTHynZtZtZtZtZtZtZtZtZtZtZtZtZtZtZtZtZtZtZtZtZtZtZtZtZtZtZtZtZtZtZtZtZtZtZtZtZt
ZtZtZtZtZtZtZtZtZtZtZtZtZtZtZtZtZtZtZtZtZtZtZtZtZtZtZtZtZtZtZtZtZtZtZtZtynTHTHTHTHTHynfsynLqLqZtZtZtZtZtLqLqynfsynTHTHTHTHTHynZtZtZtZtZtZtZtZtZtZtZtZtZtZtZtZtZtZtZtZtZtZtZtZtZtZtZtZtZtZtZtZtZtZtZtZtZt
ZtZtZtZtZtZtZtZtZtZtZtZtZtZtZtZtZtZtZtZtZtZtZtZtZtZtZtZtZtZtZtZtZtZtZtZtynTHTHTHTHTHynfsynynLqLqLqZtLqLqLqynynfsynynynTHynynynynZtZtZtZtZtZtZtZtZtZtZtZtZtZtZtZtZtZtZtZtZtZtZtZtZtZtZtZtZtZtZtZtZtZtZtZt
ZtZtZtZtZtZtZtZtZtZtZtZtZtZtZtZtZtZtZtZtZtZtZtZtZtZtZtZtZtZtZtZtZtZtZtZtynynTHynynynynfsynynynynZtZtZtynynynynfsynTHTHTHTHTHTHynZtZtZtZtZtZtZtZtZtZtZtZtZtZtZtZtZtZtZtZtZtZtZtZtZtZtZtZtZtZtZtZtZtZtZtZt
ZtZtZtZtZtZtZtZtZtZtZtZtZtZtZtZtZtZtZtZtZtZtZtZtZtZtZtZtZtZtZtZtZtZtZtZtynTHTHTHTHTHyniwynTHTHynZtZtZtynTHTHyniwynTHTHTHTHTHTHynZtZtZtZtZtZtZtZtZtZtZtZtZtZtZtZtZtZtZtZtZtZtZtZtZtZtZtZtZtZtZtZtZtZtZtZt
ZtZtZtZtZtZtZtZtZtZtZtZtZtZtZtZtZtZtZtZtZtZtZtZtZtZtZtZtZtZtZtZtZtZtZtZtynTHTHTHTHTHynynynTHTHynNnNnNnynTHTHynynynTHTHTHTHTHTHynZtZtZtZtZtZtZtZtZtZtZtZtZtZtZtZtZtZtZtZtZtZtZtZtZtZtZtZtZtZtZtZtZtZtZtZt
ZtZtZtZtZtZtZtZtZtZtZtZtZtZtZtZtZtZtZtZtZtZtZtZtZtZtZtZtZtZtZtZtZtZtZtZtynTHTHTHTHTHynTHTHTHTHynNnNnNnynTHTHTHTHTHTHTHTHTHTHTHynZtZtZtZtZtZtZtZtZtZtZtZtZtZtZtZtZtZtZtZtZtZtZtZtZtZtZtZtZtZtZtZtZtZtZtZt
ZtZtZtZtZtZtZtZtZtZtZtZtZtZtZtZtZtZtZtZtZtZtZtZtZtZtZtZtZtZtZtZtZtZtZtZtynynTHynynynynTHTHTHTHynNnzHNnynTHTHTHTHTHTHTHTHTHTHynynZtZtZtZtZtZtZtZtZtZtZtZtZtZtZtZtZtZtZtZtZtZtZtZtZtZtZtZtZtZtZtZtZtZtZtZt
ZtZtZtZtZtZtZtZtZtZtZtZtZtZtZtZtZtZtZtZtZtZtZtZtZtZtZtZtZtZtZtZtZtZtZtZtynTHTHTHTHTHTHTHTHTHzHzHzHzHzHzHzHTHTHTHTHTHTHTHTHTHynZtZtZtZtZtZtZtZtZtZtZtZtZtZtZtZtZtZtZtZtZtZtZtZtZtZtZtZtZtZtZtZtZtZtZtZtZt
ZtZtZtZtZtZtZtZtZtZtZtZtZtZtZtZtZtZtZtZtZtZtZtZtZtZtZtZtZtZtZtZtZtZtZtZtynTHTHTHTHTHTHTHTHTHTHTHzHTHTHTHzHTHTHTHTHTHTHTHTHTHynZtZtZtZtZtZtZtZtZtZtZtZtZtZtZtZtZtZtZtZtZtZtZtZtZtZtZtZtZtZtZtZtZtZtZtZtZt
ZtZtZtZtZtZtZtZtZtZtZtZtZtZtZtZtZtZtZtZtZtZtZtZtZtZtZtZtZtZtZtZtZtZtZtZtynTHTHTHTHTHTHTHTHTHTHynTHTHTHynTHTHTHTHTHTHTHTHTHynynZtZtZtZtZtZtZtZtZtZtZtZtZtZtZtZtZtZtZtZtZtZtZtZtZtZtZtZtZtZtZtZtZtZtZtZtZt
ZtZtZtZtZtZtZtZtZtZtZtZtZtZtZtZtZtZtZtZtZtZtZtZtZtZtZtZtZtZtZtZtZtZtZtZtynTHTHTHTHTHTHTHTHTHTHynynynynynTHTHTHTHTHTHTHTHTHynZtZtZtZtZtZtZtZtZtZtZtZtZtZtZtZtZtZtZtZtZtZtZtZtZtZtZtZtZtZtZtZtZtZtZtZtZtZt
ZtZtZtZtZtZtZtZtZtZtZtZtZtZtZtZtZtZtZtZtZtZtZtZtZtZtZtZtZtZtZtZtZtZtZtZtynynynynynynynynynynynynBiBiBiynTHTHTHTHTHTHTHynynynZtZtZtZtZtZtZtZtZtZtZtZtZtZtZtZtZtZtZtZtZtZtZtZtZtZtZtZtZtZtZtZtZtZtZtZtZtZt
ZtZtZtZtZtZtZtZtZtZtZtZtZtZtZtZtZtZtZtZtZtZtZtZtZtZtZtZtZtZtZtZtZtZtZtZtZtZtZtZtRZRZRZRZRZRZRZRZRZRZRZynTHTHTHTHynynynynZtZtZtZtZtZtZtZtZtZtZtZtZtZtZtZtZtZtZtZtZtZtZtZtZtZtZtZtZtZtZtZtZtZtZtZtZtZtZtZt
ZtZtZtZtZtZtZtZtZtZtZtZtZtZtZtZtZtZtZtZtZtZtZtZtZtZtZtZtZtZtZtZtZtZtZtZtZtZtZtZtRZRZRZRZRZRZRZRZRZRZRZynynynynynynZtZtZtZtZtZtZtZtZtZtZtZtZtZtZtZtZtZtZtZtZtZtZtZtZtZtZtZtZtZtZtZtZtZtZtZtZtZtZtZtZtZtZt
ZtZtZtZtZtZtZtZtZtZtZtZtZtZtZtZtZtZtZtZtZtZtZtZtZtZtZtZtZtZtZtZtZtZtZtZtZtZtZtZtRZRZRZRZRZRZRZRZRZRZRZRZRZRZRZRZRZZtZtZtZtZtZtZtZtZtZtZtZtZtZtZtZtZtZtZtZtZtZtZtZtZtZtZtZtZtZtZtZtZtZtZtZtZtZtZtZtZtZtZt
ZtZtZtZtZtZtZtZtZtZtZtZtZtZtZtZtZtZtZtZtZtZtZtZtZtZtZtZtZtZtZtZtZtZtZtZtZtZtZtZtRZRZRZRZRZRZRZRZRZRZRZRZRZRZRZRZRZZtZtZtZtZtZtZtZtZtZtZtZtZtZtZtZtZtZtZtZtZtZtZtZtZtZtZtZtZtZtZtZtZtZtZtZtZtZtZtZtZtZtZt
ZtZtZtZtZtZtZtZtZtZtZtZtZtZtZtZtZtZtZtZtZtZtZtZtZtZtZtZtZtZtZtZtZtZtZtZtZtZtZtZtRZRZRZRZRZRZRZRZRZRZRZRZRZRZRZRZRZZtZtZtZtZtZtZtZtZtZtZtZtZtZtZtZtZtZtZtZtZtZtZtZtZtZtZtZtZtZtZtZtZtZtZtZtZtZtZtZtZtZtZt
ZtZtZtZtZtZtZtZtZtZtZtZtZtZtZtZtZtZtZtZtZtZtZtZtZtZtZtZtZtZtZtZtZtZtZtZtZtZtZtZtRZRZRZRZRZRZRZRZRZRZRZRZRZRZRZRZRZZtZtZtZtZtZtZtZtZtZtZtZtZtZtZtZtZtZtZtZtZtZtZtZtZtZtZtZtZtZtZtZtZtZtZtZtZtZtZtZtZtZtZt
ZtZtZtZtZtZtZtZtZtZtZtZtZtZtZtZtZtZtZtZtZtZtZtZtZtZtZtZtZtZtZtZtZtZtZtZtZtZtZtZtZtZtZtZtZtZtZtZtZtZtZtZtZtZtZtZtZtZtZtZtZtZtZtZtZtZtZtZtZtZtZtZtZtZtZtZtZtZtZtZtZtZtZtZtZtZtZtZtZtZtZtZtZtZtZtZtZtZtZtZt
ZtZtZtZtZtZtZtZtZtZtZtZtZtZtZtZtZtZtZtZtZtZtZtZtZtZtZtZtZtZtZtZtZtZtZtZtZtZtZtZtZtZtZtZtZtZtZtZtZtZtZtZtZtZtZtZtZtZtZtZtZtZtZtZtZtZtZtZtZtZtZtZtZtZtZtZtZtZtZtZtZtZtZtZtZtZtZtZtZtZtZtZtZtZtZtZtZtZtZtZt
ZtZtZtZtZtZtZtZtZtZtZtZtZtZtZtZtZtZtZtZtZtZtZtZtZtZtZtZtZtZtZtZtZtZtZtZtZtZtZtZtZtZtZtZtZtZtZtZtZtZtZtZtZtZtZtZtZtZtZtZtZtZtZtZtZtZtZtZtZtZtZtZtZtZtZtZtZtZtZtZtZtZtZtZtZtZtZtZtZtZtZtZtZtZtZtZtZtZtZtZt
ZtZtZtZtZtZtZtZtZtZtZtZtZtZtZtZtZtZtZtZtZtZtZtZtZtZtZtZtZtZtZtZtZtZtZtZtZtZtZtZtZtZtZtZtZtZtZtZtZtZtZtZtZtZtZtZtZtZtZtZtZtZtZtZtZtZtZtZtZtZtZtZtZtZtZtZtZtZtZtZtZtZtZtZtZtZtZtZtZtZtZtZtZtZtZtZtZtZtZtZt
ZtZtZtZtZtZtZtZtZtZtZtZtZtZtZtZtZtZtZtZtZtZtZtZtZtZtZtZtZtZtZtZtZtZtZtZtZtZtZtZtZtZtZtZtZtZtZtZtZtZtZtZtZtZtZtZtZtZtZtZtZtZtZtZtZtZtZtZtZtZtZtZtZtZtZtZtZtZtZtZtZtZtZtZtZtZtZtZtZtZtZtZtZtZtZtZtZtZtZtZt
ZtZtZtZtZtZtZtZtZtZtZtZtZtZtZtZtZtZtZtZtZtZtZtZtZtZtZtZtZtZtZtZtZtZtZtZtZtZtZtZtZtZtZtZtZtZtZtZtZtZtZtZtZtZtZtZtZtZtZtZtZtZtZtZtZtZtZtZtZtZtZtZtZtZtZtZtZtZtZtZtZtZtZtZtZtZtZtZtZtZtZtZtZtZtZtZtZtZtZtZt
ZtZtZtZtZtZtZtZtZtZtZtZtZtZtZtZtZtZtZtZtZtZtZtZtZtZtZtZtZtZtZtZtZtZtZtZtZtZtZtZtZtZtZtZtZtZtZtZtZtZtZtZtZtZtZtZtZtZtZtZtZtZtZtZtZtZtZtZtZtZtZtZtZtZtZtZtZtZtZtZtZtZtZtZtZtZtZtZtZtZtZtZtZtZtZtZtZtZtZtZt
ZtZtZtZtZtZtZtZtZtZtZtZtZtZtZtZtZtZtZtZtZtZtZtZtZtZtZtZtZtZtZtZtZtZtZtZtZtZtZtZtZtZtZtZtZtZtZtZtZtZtZtZtZtZtZtZtZtZtZtZtZtZtZtZtZtZtZtZtZtZtZtZtZtZtZtZtZtZtZtZtZtZtZtZtZtZtZtZtZtZtZtZtZtZtZtZtZtZtZtZt
ZtZtZtZtZtZtZtZtZtZtZtZtZtZtZtZtZtZtZtZtZtZtZtZtZtZtZtZtZtZtZtZtZtZtZtZtZtZtZtZtZtZtZtZtZtZtZtZtZtZtZtZtZtZtZtZtZtZtZtZtZtZtZtZtZtZtZtZtZtZtZtZtZtZtZtZtZtZtZtZtZtZtZtZtZtZtZtZtZtZtZtZtZtZtZtZtZtZtZtZt
ZtZtZtZtZtZtZtZtZtZtZtZtZtZtZtZtZtZtZtZtZtZtZtZtZtZtZtZtZtZtZtZtZtZtZtZtZtZtZtZtZtZtZtZtZtZtZtZtZtZtZtZtZtZtZtZtZtZtZtZtZtZtZtZtZtZtZtZtZtZtZtZtZtZtZtZtZtZtZtZtZtZtZtZtZtZtZtZtZtZtZtZtZtZtZtZtZtZtZtZt
ZtZtZtZtZtZtZtZtZtZtZtZtZtZtZtZtZtZtZtZtZtZtZtZtZtZtZtZtZtZtZtZtZtZtZtZtZtZtZtZtZtZtZtZtZtZtZtZtZtZtZtZtZtZtZtZtZtZtZtZtZtZtZtZtZtZtZtZtZtZtZtZtZtZtZtZtZtZtZtZtZtZtZtZtZtZtZtZtZtZtZtZtZtZtZtZtZtZtZtZt
ZtZtZtZtZtZtZtZtZtZtZtZtZtZtZtZtZtZtZtZtZtZtZtZtZtZtZtZtZtZtZtZtZtZtZtZtZtZtZtZtZtZtZtZtZtZtZtZtZtZtZtZtZtZtZtZtZtZtZtZtZtZtZtZtZtZtZtZtZtZtZtZtZtZtZtZtZtZtZtZtZtZtZtZtZtZtZtZtZtZtZtZtZtZtZtZtZtZtZtZt
ZtZtZtZtZtZtZtZtZtZtZtZtZtZtZtZtZtZtZtZtZtZtZtZtZtZtZtZtZtZtZtZtZtZtZtZtZtZtZtZtZtZtZtZtZtZtZtZtZtZtZtZtZtZtZtZtZtZtZtZtZtZtZtZtZtZtZtZtZtZtZtZtZtZtZtZtZtZtZtZtZtZtZtZtZtZtZtZtZtZtZtZtZtZtZtZtZtZtZtZt
ZtZtZtZtZtZtZtZtZtZtZtZtZtZtZtZtZtZtZtZtZtZtZtZtZtZtZtZtZtZtZtZtZtZtZtZtZtZtZtZtZtZtZtZtZtZtZtZtZtZtZtZtZtZtZtZtZtZtZtZtZtZtZtZtZtZtZtZtZtZtZtZtZtZtZtZtZtZtZtZtZtZtZtZtZtZtZtZtZtZtZtZtZtZtZtZtZtZtZtZt
ZtZtZtZtZtZtZtZtZtZtZtZtZtZtZtZtZtZtZtZtZtZtZtZtZtZtZtZtZtZtZtZtZtZtZtZtZtZtZtZtZtZtZtZtZtZtZtZtZtZtZtZtZtZtZtZtZtZtZtZtZtZtZtZtZtZtZtZtZtZtZtZtZtZtZtZtZtZtZtZtZtZtZtZtZtZtZtZtZtZtZtZtZtZtZtZtZtZtZtZt
ZtZtZtZtZtZtZtZtZtZtZtZtZtZtZtZtZtZtZtZtZtZtZtZtZtZtZtZtZtZtZtZtZtZtZtZtZtZtZtZtZtZtZtZtZtZtZtZtZtZtZtZtZtZtZtZtZtZtZtZtZtZtZtZtZtZtZtZtZtZtZtZtZtZtZtZtZtZtZtZtZtZtZtZtZtZtZtZtZtZtZtZtZtZtZtZtZtZtZtZt
ZtZtZtZtZtZtZtZtZtZtZtZtZtZtZtZtZtZtZtZtZtZtZtZtZtZtZtZtZtZtZtZtZtZtZtZtZtZtZtZtZtZtZtZtZtZtZtZtZtZtZtZtZtZtZtZtZtZtZtZtZtZtZtZtZtZtZtZtZtZtZtZtZtZtZtZtZtZtZtZtZtZtZtZtZtZtZtZtZtZtZtZtZtZtZtZtZtZtZtZt
ZtZtZtZtZtZtZtZtZtZtZtZtZtZtZtZtZtZtZtZtZtZtZtZtZtZtZtZtZtZtZtZtZtZtZtZtZtZtZtZtZtZtZtZtZtZtZtZtZtZtZtZtZtZtZtZtZtZtZtZtZtZtZtZtZtZtZtZtZtZtZtZtZtZtZtZtZtZtZtZtZtZtZtZtZtZtZtZtZtZtZtZtZtZtZtZtZtZtZtZt
ZtZtZtZtZtZtZtZtZtZtZtZtZtZtZtZtZtZtZtZtZtZtZtZtZtZtZtZtZtZtZtZtZtZtZtZtZtZtZtZtZtZtZtZtZtZtZtZtZtZtZtZtZtZtZtZtZtZtZtZtZtZtZtZtZtZtZtZtZtZtZtZtZtZtZtZtZtZtZtZtZtZtZtZtZtZtZtZtZtZtZtZtZtZtZtZtZtZtZtZt
ZtZtZtZtZtZtZtZtZtZtZtZtZtZtZtZtZtZtZtZtZtZtZtZtZtZtZtZtZtZtZtZtZtZtZtZtZtZtZtZtZtZtZtZtZtZtZtZtZtZtZtZtZtZtZtZtZtZtZtZtZtZtZtZtZtZtZtZtZtZtZtZtZtZtZtZtZtZtZtZtZtZtZtZtZtZtZtZtZtZtZtZtZtZtZtZtZtZtZtZt
ZtZtZtZtZtZtZtZtZtZtZtZtZtZtZtZtZtZtZtZtZtZtZtZtZtZtZtZtZtZtZtZtZtZtZtZtZtZtZtZtZtZtZtZtZtZtZtZtZtZtZtZtZtZtZtZtZtZtZtZtZtZtZtZtZtZtZtZtZtZtZtZtZtZtZtZtZtZtZtZtZtZtZtZtZtZtZtZtZtZtZtZtZtZtZtZtZtZtZtZt
ZtZtZtZtZtZtZtZtZtZtZtZtZtZtZtZtZtZtZtZtZtZtZtZtZtZtZtZtZtZtZtZtZtZtZtZtZtZtZtZtZtZtZtZtZtZtZtZtZtZtZtZtZtZtZtZtZtZtZtZtZtZtZtZtZtZtZtZtZtZtZtZtZtZtZtZtZtZtZtZtZtZtZtZtZtZtZtZtZtZtZtZtZtZtZtZtZtZtZtZt
ZtZtZtZtZtZtZtZtZtZtZtZtZtZtZtZtZtZtZtZtZtZtZtZtZtZtZtZtZtZtZtZtZtZtZtZtZtZtZtZtZtZtZtZtZtZtZtZtZtZtZtZtZtZtZtZtZtZtZtZtZtZtZtZtZtZtZtZtZtZtZtZtZtZtZtZtZtZtZtZtZtZtZtZtZtZtZtZtZtZtZtZtZtZtZtZtZtZtZtZt
ZtZtZtZtZtZtZtZtZtZtZtZtZtZtZtZtZtZtZtZtZtZtZtZtZtZtZtZtZtZtZtZtZtZtZtZtZtZtZtZtZtZtZtZtZtZtZtZtZtZtZtZtZtZtZtZtZtZtZtZtZtZtZtZtZtZtZtZtZtZtZtZtZtZtZtZtZtZtZtZtZtZtZtZtZtZtZtZtZtZtZtZtZtZtZtZtZtZtZtZt
ZtZtZtZtZtZtZtZtZtZtZtZtZtZtZtZtZtZtZtZtZtZtZtZtZtZtZtZtZtZtZtZtZtZtZtZtZtZtZtZtZtZtZtZtZtZtZtZtZtZtZtZtZtZtZtZtZtZtZtZtZtZtZtZtZtZtZtZtZtZtZtZtZtZtZtZtZtZtZtZtZtZtZtZtZtZtZtZtZtZtZtZtZtZtZtZtZtZtZtZt
ZtZtZtZtZtZtZtZtZtZtZtZtZtZtZtZtZtZtZtZtZtZtZtZtZtZtZtZtZtZtZtZtZtZtZtZtZtZtZtZtZtZtZtZtZtZtZtZtZtZtZtZtZtZtZtZtZtZtZtZtZtZtZtZtZtZtZtZtZtZtZtZtZtZtZtZtZtZtZtZtZtZtZtZtZtZtZtZtZtZtZtZtZtZtZtZtZtZtZtZt
ZtZtZtZtZtZtZtZtZtZtZtZtZtZtZtZtZtZtZtZtZtZtZtZtZtZtZtZtZtZtZtZtZtZtZtZtZtZtZtZtZtZtZtZtZtZtZtZtZtZtZtZtZtZtZtZtZtZtZtZtZtZtZtZtZtZtZtZtZtZtZtZtZtZtZtZtZtZtZtZtZtZtZtZtZtZtZtZtZtZtZtZtZtZtZtZtZtZtZtZt
ZtZtZtZtZtZtZtZtZtZtZtZtZtZtZtZtZtZtZtZtZtZtZtZtZtZtZtZtZtZtZtZtZtZtZtZtZtZtZtZtZtZtZtZtZtZtZtZtZtZtZtZtZtZtZtZtZtZtZtZtZtZtZtZtZtZtZtZtZtZtZtZtZtZtZtZtZtZtZtZtZtZtZtZtZtZtZtZtZtZtZtZtZtZtZtZtZtZtZtZt
ZtZtZtZtZtZtZtZtZtZtZtZtZtZtZtZtZtZtZtZtZtZtZtZtZtZtZtZtZtZtZtZtZtZtZtZtZtZtZtZtZtZtZtZtZtZtZtZtZtZtZtZtZtZtZtZtZtZtZtZtZtZtZtZtZtZtZtZtZtZtZtZtZtZtZtZtZtZtZtZtZtZtZtZtZtZtZtZtZtZtZtZtZtZtZtZtZtZtZtZt
"}
