"Zt" = (/turf/simulated/open,/area/warfare)

(1,1,1) = {"
ZtZtZtZtZtZtZtZtZtZtZtZtZtZtZtZtZtZtZtZtZtZtZtZtZtZtZtZtZtZtZtZtZtZtZtZtZtZtZtZtZtZtZtZtZtZtZtZtZtZtZtZtZtZtZtZtZtZtZtZtZtZtZtZtZtZtZtZtZtZtZtZtZtZtZtZtZtZtZtZtZtZtZtZtZtZtZtZtZtZtZtZtZtZtZtZtZtZtZtZt
ZtZtZtZtZtZtZtZtZtZtZtZtZtZtZtZtZtZtZtZtZtZtZtZtZtZtZtZtZtZtZtZtZtZtZtZtZtZtZtZtZtZtZtZtZtZtZtZtZtZtZtZtZtZtZtZtZtZtZtZtZtZtZtZtZtZtZtZtZtZtZtZtZtZtZtZtZtZtZtZtZtZtZtZtZtZtZtZtZtZtZtZtZtZtZtZtZtZtZtZt
ZtZtZtZtZtZtZtZtZtZtZtZtZtZtZtZtZtZtZtZtZtZtZtZtZtZtZtZtZtZtZtZtZtZtZtZtZtZtZtZtZtZtZtZtZtZtZtZtZtZtZtZtZtZtZtZtZtZtZtZtZtZtZtZtZtZtZtZtZtZtZtZtZtZtZtZtZtZtZtZtZtZtZtZtZtZtZtZtZtZtZtZtZtZtZtZtZtZtZtZt
ZtZtZtZtZtZtZtZtZtZtZtZtZtZtZtZtZtZtZtZtZtZtZtZtZtZtZtZtZtZtZtZtZtZtZtZtZtZtZtZtZtZtZtZtZtZtZtZtZtZtZtZtZtZtZtZtZtZtZtZtZtZtZtZtZtZtZtZtZtZtZtZtZtZtZtZtZtZtZtZtZtZtZtZtZtZtZtZtZtZtZtZtZtZtZtZtZtZtZtZt
ZtZtZtZtZtZtZtZtZtZtZtZtZtZtZtZtZtZtZtZtZtZtZtZtZtZtZtZtZtZtZtZtZtZtZtZtZtZtZtZtZtZtZtZtZtZtZtZtZtZtZtZtZtZtZtZtZtZtZtZtZtZtZtZtZtZtZtZtZtZtZtZtZtZtZtZtZtZtZtZtZtZtZtZtZtZtZtZtZtZtZtZtZtZtZtZtZtZtZtZt
ZtZtZtZtZtZtZtZtZtZtZtZtZtZtZtZtZtZtZtZtZtZtZtZtZtZtZtZtZtZtZtZtZtZtZtZtZtZtZtZtZtZtZtZtZtZtZtZtZtZtZtZtZtZtZtZtZtZtZtZtZtZtZtZtZtZtZtZtZtZtZtZtZtZtZtZtZtZtZtZtZtZtZtZtZtZtZtZtZtZtZtZtZtZtZtZtZtZtZtZt
ZtZtZtZtZtZtZtZtZtZtZtZtZtZtZtZtZtZtZtZtZtZtZtZtZtZtZtZtZtZtZtZtZtZtZtZtZtZtZtZtZtZtZtZtZtZtZtZtZtZtZtZtZtZtZtZtZtZtZtZtZtZtZtZtZtZtZtZtZtZtZtZtZtZtZtZtZtZtZtZtZtZtZtZtZtZtZtZtZtZtZtZtZtZtZtZtZtZtZtZt
ZtZtZtZtZtZtZtZtZtZtZtZtZtZtZtZtZtZtZtZtZtZtZtZtZtZtZtZtZtZtZtZtZtZtZtZtZtZtZtZtZtZtZtZtZtZtZtZtZtZtZtZtZtZtZtZtZtZtZtZtZtZtZtZtZtZtZtZtZtZtZtZtZtZtZtZtZtZtZtZtZtZtZtZtZtZtZtZtZtZtZtZtZtZtZtZtZtZtZtZt
ZtZtZtZtZtZtZtZtZtZtZtZtZtZtZtZtZtZtZtZtZtZtZtZtZtZtZtZtZtZtZtZtZtZtZtZtZtZtZtZtZtZtZtZtZtZtZtZtZtZtZtZtZtZtZtZtZtZtZtZtZtZtZtZtZtZtZtZtZtZtZtZtZtZtZtZtZtZtZtZtZtZtZtZtZtZtZtZtZtZtZtZtZtZtZtZtZtZtZtZt
ZtZtZtZtZtZtZtZtZtZtZtZtZtZtZtZtZtZtZtZtZtZtZtZtZtZtZtZtZtZtZtZtZtZtZtZtZtZtZtZtZtZtZtZtZtZtZtZtZtZtZtZtZtZtZtZtZtZtZtZtZtZtZtZtZtZtZtZtZtZtZtZtZtZtZtZtZtZtZtZtZtZtZtZtZtZtZtZtZtZtZtZtZtZtZtZtZtZtZtZt
ZtZtZtZtZtZtZtZtZtZtZtZtZtZtZtZtZtZtZtZtZtZtZtZtZtZtZtZtZtZtZtZtZtZtZtZtZtZtZtZtZtZtZtZtZtZtZtZtZtZtZtZtZtZtZtZtZtZtZtZtZtZtZtZtZtZtZtZtZtZtZtZtZtZtZtZtZtZtZtZtZtZtZtZtZtZtZtZtZtZtZtZtZtZtZtZtZtZtZtZt
ZtZtZtZtZtZtZtZtZtZtZtZtZtZtZtZtZtZtZtZtZtZtZtZtZtZtZtZtZtZtZtZtZtZtZtZtZtZtZtZtZtZtZtZtZtZtZtZtZtZtZtZtZtZtZtZtZtZtZtZtZtZtZtZtZtZtZtZtZtZtZtZtZtZtZtZtZtZtZtZtZtZtZtZtZtZtZtZtZtZtZtZtZtZtZtZtZtZtZtZt
ZtZtZtZtZtZtZtZtZtZtZtZtZtZtZtZtZtZtZtZtZtZtZtZtZtZtZtZtZtZtZtZtZtZtZtZtZtZtZtZtZtZtZtZtZtZtZtZtZtZtZtZtZtZtZtZtZtZtZtZtZtZtZtZtZtZtZtZtZtZtZtZtZtZtZtZtZtZtZtZtZtZtZtZtZtZtZtZtZtZtZtZtZtZtZtZtZtZtZtZt
ZtZtZtZtZtZtZtZtZtZtZtZtZtZtZtZtZtZtZtZtZtZtZtZtZtZtZtZtZtZtZtZtZtZtZtZtZtZtZtZtZtZtZtZtZtZtZtZtZtZtZtZtZtZtZtZtZtZtZtZtZtZtZtZtZtZtZtZtZtZtZtZtZtZtZtZtZtZtZtZtZtZtZtZtZtZtZtZtZtZtZtZtZtZtZtZtZtZtZtZt
ZtZtZtZtZtZtZtZtZtZtZtZtZtZtZtZtZtZtZtZtZtZtZtZtZtZtZtZtZtZtZtZtZtZtZtZtZtZtZtZtZtZtZtZtZtZtZtZtZtZtZtZtZtZtZtZtZtZtZtZtZtZtZtZtZtZtZtZtZtZtZtZtZtZtZtZtZtZtZtZtZtZtZtZtZtZtZtZtZtZtZtZtZtZtZtZtZtZtZtZt
ZtZtZtZtZtZtZtZtZtZtZtZtZtZtZtZtZtZtZtZtZtZtZtZtZtZtZtZtZtZtZtZtZtZtZtZtZtZtZtZtZtZtZtZtZtZtZtZtZtZtZtZtZtZtZtZtZtZtZtZtZtZtZtZtZtZtZtZtZtZtZtZtZtZtZtZtZtZtZtZtZtZtZtZtZtZtZtZtZtZtZtZtZtZtZtZtZtZtZtZt
ZtZtZtZtZtZtZtZtZtZtZtZtZtZtZtZtZtZtZtZtZtZtZtZtZtZtZtZtZtZtZtZtZtZtZtZtZtZtZtZtZtZtZtZtZtZtZtZtZtZtZtZtZtZtZtZtZtZtZtZtZtZtZtZtZtZtZtZtZtZtZtZtZtZtZtZtZtZtZtZtZtZtZtZtZtZtZtZtZtZtZtZtZtZtZtZtZtZtZtZt
ZtZtZtZtZtZtZtZtZtZtZtZtZtZtZtZtZtZtZtZtZtZtZtZtZtZtZtZtZtZtZtZtZtZtZtZtZtZtZtZtZtZtZtZtZtZtZtZtZtZtZtZtZtZtZtZtZtZtZtZtZtZtZtZtZtZtZtZtZtZtZtZtZtZtZtZtZtZtZtZtZtZtZtZtZtZtZtZtZtZtZtZtZtZtZtZtZtZtZtZt
ZtZtZtZtZtZtZtZtZtZtZtZtZtZtZtZtZtZtZtZtZtZtZtZtZtZtZtZtZtZtZtZtZtZtZtZtZtZtZtZtZtZtZtZtZtZtZtZtZtZtZtZtZtZtZtZtZtZtZtZtZtZtZtZtZtZtZtZtZtZtZtZtZtZtZtZtZtZtZtZtZtZtZtZtZtZtZtZtZtZtZtZtZtZtZtZtZtZtZtZt
ZtZtZtZtZtZtZtZtZtZtZtZtZtZtZtZtZtZtZtZtZtZtZtZtZtZtZtZtZtZtZtZtZtZtZtZtZtZtZtZtZtZtZtZtZtZtZtZtZtZtZtZtZtZtZtZtZtZtZtZtZtZtZtZtZtZtZtZtZtZtZtZtZtZtZtZtZtZtZtZtZtZtZtZtZtZtZtZtZtZtZtZtZtZtZtZtZtZtZtZt
ZtZtZtZtZtZtZtZtZtZtZtZtZtZtZtZtZtZtZtZtZtZtZtZtZtZtZtZtZtZtZtZtZtZtZtZtZtZtZtZtZtZtZtZtZtZtZtZtZtZtZtZtZtZtZtZtZtZtZtZtZtZtZtZtZtZtZtZtZtZtZtZtZtZtZtZtZtZtZtZtZtZtZtZtZtZtZtZtZtZtZtZtZtZtZtZtZtZtZtZt
ZtZtZtZtZtZtZtZtZtZtZtZtZtZtZtZtZtZtZtZtZtZtZtZtZtZtZtZtZtZtZtZtZtZtZtZtZtZtZtZtZtZtZtZtZtZtZtZtZtZtZtZtZtZtZtZtZtZtZtZtZtZtZtZtZtZtZtZtZtZtZtZtZtZtZtZtZtZtZtZtZtZtZtZtZtZtZtZtZtZtZtZtZtZtZtZtZtZtZtZt
ZtZtZtZtZtZtZtZtZtZtZtZtZtZtZtZtZtZtZtZtZtZtZtZtZtZtZtZtZtZtZtZtZtZtZtZtZtZtZtZtZtZtZtZtZtZtZtZtZtZtZtZtZtZtZtZtZtZtZtZtZtZtZtZtZtZtZtZtZtZtZtZtZtZtZtZtZtZtZtZtZtZtZtZtZtZtZtZtZtZtZtZtZtZtZtZtZtZtZtZt
ZtZtZtZtZtZtZtZtZtZtZtZtZtZtZtZtZtZtZtZtZtZtZtZtZtZtZtZtZtZtZtZtZtZtZtZtZtZtZtZtZtZtZtZtZtZtZtZtZtZtZtZtZtZtZtZtZtZtZtZtZtZtZtZtZtZtZtZtZtZtZtZtZtZtZtZtZtZtZtZtZtZtZtZtZtZtZtZtZtZtZtZtZtZtZtZtZtZtZtZt
ZtZtZtZtZtZtZtZtZtZtZtZtZtZtZtZtZtZtZtZtZtZtZtZtZtZtZtZtZtZtZtZtZtZtZtZtZtZtZtZtZtZtZtZtZtZtZtZtZtZtZtZtZtZtZtZtZtZtZtZtZtZtZtZtZtZtZtZtZtZtZtZtZtZtZtZtZtZtZtZtZtZtZtZtZtZtZtZtZtZtZtZtZtZtZtZtZtZtZtZt
ZtZtZtZtZtZtZtZtZtZtZtZtZtZtZtZtZtZtZtZtZtZtZtZtZtZtZtZtZtZtZtZtZtZtZtZtZtZtZtZtZtZtZtZtZtZtZtZtZtZtZtZtZtZtZtZtZtZtZtZtZtZtZtZtZtZtZtZtZtZtZtZtZtZtZtZtZtZtZtZtZtZtZtZtZtZtZtZtZtZtZtZtZtZtZtZtZtZtZtZt
ZtZtZtZtZtZtZtZtZtZtZtZtZtZtZtZtZtZtZtZtZtZtZtZtZtZtZtZtZtZtZtZtZtZtZtZtZtZtZtZtZtZtZtZtZtZtZtZtZtZtZtZtZtZtZtZtZtZtZtZtZtZtZtZtZtZtZtZtZtZtZtZtZtZtZtZtZtZtZtZtZtZtZtZtZtZtZtZtZtZtZtZtZtZtZtZtZtZtZtZt
ZtZtZtZtZtZtZtZtZtZtZtZtZtZtZtZtZtZtZtZtZtZtZtZtZtZtZtZtZtZtZtZtZtZtZtZtZtZtZtZtZtZtZtZtZtZtZtZtZtZtZtZtZtZtZtZtZtZtZtZtZtZtZtZtZtZtZtZtZtZtZtZtZtZtZtZtZtZtZtZtZtZtZtZtZtZtZtZtZtZtZtZtZtZtZtZtZtZtZtZt
ZtZtZtZtZtZtZtZtZtZtZtZtZtZtZtZtZtZtZtZtZtZtZtZtZtZtZtZtZtZtZtZtZtZtZtZtZtZtZtZtZtZtZtZtZtZtZtZtZtZtZtZtZtZtZtZtZtZtZtZtZtZtZtZtZtZtZtZtZtZtZtZtZtZtZtZtZtZtZtZtZtZtZtZtZtZtZtZtZtZtZtZtZtZtZtZtZtZtZtZt
ZtZtZtZtZtZtZtZtZtZtZtZtZtZtZtZtZtZtZtZtZtZtZtZtZtZtZtZtZtZtZtZtZtZtZtZtZtZtZtZtZtZtZtZtZtZtZtZtZtZtZtZtZtZtZtZtZtZtZtZtZtZtZtZtZtZtZtZtZtZtZtZtZtZtZtZtZtZtZtZtZtZtZtZtZtZtZtZtZtZtZtZtZtZtZtZtZtZtZtZt
ZtZtZtZtZtZtZtZtZtZtZtZtZtZtZtZtZtZtZtZtZtZtZtZtZtZtZtZtZtZtZtZtZtZtZtZtZtZtZtZtZtZtZtZtZtZtZtZtZtZtZtZtZtZtZtZtZtZtZtZtZtZtZtZtZtZtZtZtZtZtZtZtZtZtZtZtZtZtZtZtZtZtZtZtZtZtZtZtZtZtZtZtZtZtZtZtZtZtZtZt
ZtZtZtZtZtZtZtZtZtZtZtZtZtZtZtZtZtZtZtZtZtZtZtZtZtZtZtZtZtZtZtZtZtZtZtZtZtZtZtZtZtZtZtZtZtZtZtZtZtZtZtZtZtZtZtZtZtZtZtZtZtZtZtZtZtZtZtZtZtZtZtZtZtZtZtZtZtZtZtZtZtZtZtZtZtZtZtZtZtZtZtZtZtZtZtZtZtZtZtZt
ZtZtZtZtZtZtZtZtZtZtZtZtZtZtZtZtZtZtZtZtZtZtZtZtZtZtZtZtZtZtZtZtZtZtZtZtZtZtZtZtZtZtZtZtZtZtZtZtZtZtZtZtZtZtZtZtZtZtZtZtZtZtZtZtZtZtZtZtZtZtZtZtZtZtZtZtZtZtZtZtZtZtZtZtZtZtZtZtZtZtZtZtZtZtZtZtZtZtZtZt
ZtZtZtZtZtZtZtZtZtZtZtZtZtZtZtZtZtZtZtZtZtZtZtZtZtZtZtZtZtZtZtZtZtZtZtZtZtZtZtZtZtZtZtZtZtZtZtZtZtZtZtZtZtZtZtZtZtZtZtZtZtZtZtZtZtZtZtZtZtZtZtZtZtZtZtZtZtZtZtZtZtZtZtZtZtZtZtZtZtZtZtZtZtZtZtZtZtZtZtZt
ZtZtZtZtZtZtZtZtZtZtZtZtZtZtZtZtZtZtZtZtZtZtZtZtZtZtZtZtZtZtZtZtZtZtZtZtZtZtZtZtZtZtZtZtZtZtZtZtZtZtZtZtZtZtZtZtZtZtZtZtZtZtZtZtZtZtZtZtZtZtZtZtZtZtZtZtZtZtZtZtZtZtZtZtZtZtZtZtZtZtZtZtZtZtZtZtZtZtZtZt
ZtZtZtZtZtZtZtZtZtZtZtZtZtZtZtZtZtZtZtZtZtZtZtZtZtZtZtZtZtZtZtZtZtZtZtZtZtZtZtZtZtZtZtZtZtZtZtZtZtZtZtZtZtZtZtZtZtZtZtZtZtZtZtZtZtZtZtZtZtZtZtZtZtZtZtZtZtZtZtZtZtZtZtZtZtZtZtZtZtZtZtZtZtZtZtZtZtZtZtZt
ZtZtZtZtZtZtZtZtZtZtZtZtZtZtZtZtZtZtZtZtZtZtZtZtZtZtZtZtZtZtZtZtZtZtZtZtZtZtZtZtZtZtZtZtZtZtZtZtZtZtZtZtZtZtZtZtZtZtZtZtZtZtZtZtZtZtZtZtZtZtZtZtZtZtZtZtZtZtZtZtZtZtZtZtZtZtZtZtZtZtZtZtZtZtZtZtZtZtZtZt
ZtZtZtZtZtZtZtZtZtZtZtZtZtZtZtZtZtZtZtZtZtZtZtZtZtZtZtZtZtZtZtZtZtZtZtZtZtZtZtZtZtZtZtZtZtZtZtZtZtZtZtZtZtZtZtZtZtZtZtZtZtZtZtZtZtZtZtZtZtZtZtZtZtZtZtZtZtZtZtZtZtZtZtZtZtZtZtZtZtZtZtZtZtZtZtZtZtZtZtZt
ZtZtZtZtZtZtZtZtZtZtZtZtZtZtZtZtZtZtZtZtZtZtZtZtZtZtZtZtZtZtZtZtZtZtZtZtZtZtZtZtZtZtZtZtZtZtZtZtZtZtZtZtZtZtZtZtZtZtZtZtZtZtZtZtZtZtZtZtZtZtZtZtZtZtZtZtZtZtZtZtZtZtZtZtZtZtZtZtZtZtZtZtZtZtZtZtZtZtZtZt
ZtZtZtZtZtZtZtZtZtZtZtZtZtZtZtZtZtZtZtZtZtZtZtZtZtZtZtZtZtZtZtZtZtZtZtZtZtZtZtZtZtZtZtZtZtZtZtZtZtZtZtZtZtZtZtZtZtZtZtZtZtZtZtZtZtZtZtZtZtZtZtZtZtZtZtZtZtZtZtZtZtZtZtZtZtZtZtZtZtZtZtZtZtZtZtZtZtZtZtZt
ZtZtZtZtZtZtZtZtZtZtZtZtZtZtZtZtZtZtZtZtZtZtZtZtZtZtZtZtZtZtZtZtZtZtZtZtZtZtZtZtZtZtZtZtZtZtZtZtZtZtZtZtZtZtZtZtZtZtZtZtZtZtZtZtZtZtZtZtZtZtZtZtZtZtZtZtZtZtZtZtZtZtZtZtZtZtZtZtZtZtZtZtZtZtZtZtZtZtZtZt
ZtZtZtZtZtZtZtZtZtZtZtZtZtZtZtZtZtZtZtZtZtZtZtZtZtZtZtZtZtZtZtZtZtZtZtZtZtZtZtZtZtZtZtZtZtZtZtZtZtZtZtZtZtZtZtZtZtZtZtZtZtZtZtZtZtZtZtZtZtZtZtZtZtZtZtZtZtZtZtZtZtZtZtZtZtZtZtZtZtZtZtZtZtZtZtZtZtZtZtZt
ZtZtZtZtZtZtZtZtZtZtZtZtZtZtZtZtZtZtZtZtZtZtZtZtZtZtZtZtZtZtZtZtZtZtZtZtZtZtZtZtZtZtZtZtZtZtZtZtZtZtZtZtZtZtZtZtZtZtZtZtZtZtZtZtZtZtZtZtZtZtZtZtZtZtZtZtZtZtZtZtZtZtZtZtZtZtZtZtZtZtZtZtZtZtZtZtZtZtZtZt
ZtZtZtZtZtZtZtZtZtZtZtZtZtZtZtZtZtZtZtZtZtZtZtZtZtZtZtZtZtZtZtZtZtZtZtZtZtZtZtZtZtZtZtZtZtZtZtZtZtZtZtZtZtZtZtZtZtZtZtZtZtZtZtZtZtZtZtZtZtZtZtZtZtZtZtZtZtZtZtZtZtZtZtZtZtZtZtZtZtZtZtZtZtZtZtZtZtZtZtZt
ZtZtZtZtZtZtZtZtZtZtZtZtZtZtZtZtZtZtZtZtZtZtZtZtZtZtZtZtZtZtZtZtZtZtZtZtZtZtZtZtZtZtZtZtZtZtZtZtZtZtZtZtZtZtZtZtZtZtZtZtZtZtZtZtZtZtZtZtZtZtZtZtZtZtZtZtZtZtZtZtZtZtZtZtZtZtZtZtZtZtZtZtZtZtZtZtZtZtZtZt
ZtZtZtZtZtZtZtZtZtZtZtZtZtZtZtZtZtZtZtZtZtZtZtZtZtZtZtZtZtZtZtZtZtZtZtZtZtZtZtZtZtZtZtZtZtZtZtZtZtZtZtZtZtZtZtZtZtZtZtZtZtZtZtZtZtZtZtZtZtZtZtZtZtZtZtZtZtZtZtZtZtZtZtZtZtZtZtZtZtZtZtZtZtZtZtZtZtZtZtZt
ZtZtZtZtZtZtZtZtZtZtZtZtZtZtZtZtZtZtZtZtZtZtZtZtZtZtZtZtZtZtZtZtZtZtZtZtZtZtZtZtZtZtZtZtZtZtZtZtZtZtZtZtZtZtZtZtZtZtZtZtZtZtZtZtZtZtZtZtZtZtZtZtZtZtZtZtZtZtZtZtZtZtZtZtZtZtZtZtZtZtZtZtZtZtZtZtZtZtZtZt
ZtZtZtZtZtZtZtZtZtZtZtZtZtZtZtZtZtZtZtZtZtZtZtZtZtZtZtZtZtZtZtZtZtZtZtZtZtZtZtZtZtZtZtZtZtZtZtZtZtZtZtZtZtZtZtZtZtZtZtZtZtZtZtZtZtZtZtZtZtZtZtZtZtZtZtZtZtZtZtZtZtZtZtZtZtZtZtZtZtZtZtZtZtZtZtZtZtZtZtZt
ZtZtZtZtZtZtZtZtZtZtZtZtZtZtZtZtZtZtZtZtZtZtZtZtZtZtZtZtZtZtZtZtZtZtZtZtZtZtZtZtZtZtZtZtZtZtZtZtZtZtZtZtZtZtZtZtZtZtZtZtZtZtZtZtZtZtZtZtZtZtZtZtZtZtZtZtZtZtZtZtZtZtZtZtZtZtZtZtZtZtZtZtZtZtZtZtZtZtZtZt
ZtZtZtZtZtZtZtZtZtZtZtZtZtZtZtZtZtZtZtZtZtZtZtZtZtZtZtZtZtZtZtZtZtZtZtZtZtZtZtZtZtZtZtZtZtZtZtZtZtZtZtZtZtZtZtZtZtZtZtZtZtZtZtZtZtZtZtZtZtZtZtZtZtZtZtZtZtZtZtZtZtZtZtZtZtZtZtZtZtZtZtZtZtZtZtZtZtZtZtZt
ZtZtZtZtZtZtZtZtZtZtZtZtZtZtZtZtZtZtZtZtZtZtZtZtZtZtZtZtZtZtZtZtZtZtZtZtZtZtZtZtZtZtZtZtZtZtZtZtZtZtZtZtZtZtZtZtZtZtZtZtZtZtZtZtZtZtZtZtZtZtZtZtZtZtZtZtZtZtZtZtZtZtZtZtZtZtZtZtZtZtZtZtZtZtZtZtZtZtZtZt
ZtZtZtZtZtZtZtZtZtZtZtZtZtZtZtZtZtZtZtZtZtZtZtZtZtZtZtZtZtZtZtZtZtZtZtZtZtZtZtZtZtZtZtZtZtZtZtZtZtZtZtZtZtZtZtZtZtZtZtZtZtZtZtZtZtZtZtZtZtZtZtZtZtZtZtZtZtZtZtZtZtZtZtZtZtZtZtZtZtZtZtZtZtZtZtZtZtZtZtZt
ZtZtZtZtZtZtZtZtZtZtZtZtZtZtZtZtZtZtZtZtZtZtZtZtZtZtZtZtZtZtZtZtZtZtZtZtZtZtZtZtZtZtZtZtZtZtZtZtZtZtZtZtZtZtZtZtZtZtZtZtZtZtZtZtZtZtZtZtZtZtZtZtZtZtZtZtZtZtZtZtZtZtZtZtZtZtZtZtZtZtZtZtZtZtZtZtZtZtZtZt
ZtZtZtZtZtZtZtZtZtZtZtZtZtZtZtZtZtZtZtZtZtZtZtZtZtZtZtZtZtZtZtZtZtZtZtZtZtZtZtZtZtZtZtZtZtZtZtZtZtZtZtZtZtZtZtZtZtZtZtZtZtZtZtZtZtZtZtZtZtZtZtZtZtZtZtZtZtZtZtZtZtZtZtZtZtZtZtZtZtZtZtZtZtZtZtZtZtZtZtZt
ZtZtZtZtZtZtZtZtZtZtZtZtZtZtZtZtZtZtZtZtZtZtZtZtZtZtZtZtZtZtZtZtZtZtZtZtZtZtZtZtZtZtZtZtZtZtZtZtZtZtZtZtZtZtZtZtZtZtZtZtZtZtZtZtZtZtZtZtZtZtZtZtZtZtZtZtZtZtZtZtZtZtZtZtZtZtZtZtZtZtZtZtZtZtZtZtZtZtZtZt
ZtZtZtZtZtZtZtZtZtZtZtZtZtZtZtZtZtZtZtZtZtZtZtZtZtZtZtZtZtZtZtZtZtZtZtZtZtZtZtZtZtZtZtZtZtZtZtZtZtZtZtZtZtZtZtZtZtZtZtZtZtZtZtZtZtZtZtZtZtZtZtZtZtZtZtZtZtZtZtZtZtZtZtZtZtZtZtZtZtZtZtZtZtZtZtZtZtZtZtZt
ZtZtZtZtZtZtZtZtZtZtZtZtZtZtZtZtZtZtZtZtZtZtZtZtZtZtZtZtZtZtZtZtZtZtZtZtZtZtZtZtZtZtZtZtZtZtZtZtZtZtZtZtZtZtZtZtZtZtZtZtZtZtZtZtZtZtZtZtZtZtZtZtZtZtZtZtZtZtZtZtZtZtZtZtZtZtZtZtZtZtZtZtZtZtZtZtZtZtZtZt
ZtZtZtZtZtZtZtZtZtZtZtZtZtZtZtZtZtZtZtZtZtZtZtZtZtZtZtZtZtZtZtZtZtZtZtZtZtZtZtZtZtZtZtZtZtZtZtZtZtZtZtZtZtZtZtZtZtZtZtZtZtZtZtZtZtZtZtZtZtZtZtZtZtZtZtZtZtZtZtZtZtZtZtZtZtZtZtZtZtZtZtZtZtZtZtZtZtZtZtZt
ZtZtZtZtZtZtZtZtZtZtZtZtZtZtZtZtZtZtZtZtZtZtZtZtZtZtZtZtZtZtZtZtZtZtZtZtZtZtZtZtZtZtZtZtZtZtZtZtZtZtZtZtZtZtZtZtZtZtZtZtZtZtZtZtZtZtZtZtZtZtZtZtZtZtZtZtZtZtZtZtZtZtZtZtZtZtZtZtZtZtZtZtZtZtZtZtZtZtZtZt
ZtZtZtZtZtZtZtZtZtZtZtZtZtZtZtZtZtZtZtZtZtZtZtZtZtZtZtZtZtZtZtZtZtZtZtZtZtZtZtZtZtZtZtZtZtZtZtZtZtZtZtZtZtZtZtZtZtZtZtZtZtZtZtZtZtZtZtZtZtZtZtZtZtZtZtZtZtZtZtZtZtZtZtZtZtZtZtZtZtZtZtZtZtZtZtZtZtZtZtZt
ZtZtZtZtZtZtZtZtZtZtZtZtZtZtZtZtZtZtZtZtZtZtZtZtZtZtZtZtZtZtZtZtZtZtZtZtZtZtZtZtZtZtZtZtZtZtZtZtZtZtZtZtZtZtZtZtZtZtZtZtZtZtZtZtZtZtZtZtZtZtZtZtZtZtZtZtZtZtZtZtZtZtZtZtZtZtZtZtZtZtZtZtZtZtZtZtZtZtZtZt
ZtZtZtZtZtZtZtZtZtZtZtZtZtZtZtZtZtZtZtZtZtZtZtZtZtZtZtZtZtZtZtZtZtZtZtZtZtZtZtZtZtZtZtZtZtZtZtZtZtZtZtZtZtZtZtZtZtZtZtZtZtZtZtZtZtZtZtZtZtZtZtZtZtZtZtZtZtZtZtZtZtZtZtZtZtZtZtZtZtZtZtZtZtZtZtZtZtZtZtZt
ZtZtZtZtZtZtZtZtZtZtZtZtZtZtZtZtZtZtZtZtZtZtZtZtZtZtZtZtZtZtZtZtZtZtZtZtZtZtZtZtZtZtZtZtZtZtZtZtZtZtZtZtZtZtZtZtZtZtZtZtZtZtZtZtZtZtZtZtZtZtZtZtZtZtZtZtZtZtZtZtZtZtZtZtZtZtZtZtZtZtZtZtZtZtZtZtZtZtZtZt
ZtZtZtZtZtZtZtZtZtZtZtZtZtZtZtZtZtZtZtZtZtZtZtZtZtZtZtZtZtZtZtZtZtZtZtZtZtZtZtZtZtZtZtZtZtZtZtZtZtZtZtZtZtZtZtZtZtZtZtZtZtZtZtZtZtZtZtZtZtZtZtZtZtZtZtZtZtZtZtZtZtZtZtZtZtZtZtZtZtZtZtZtZtZtZtZtZtZtZtZt
ZtZtZtZtZtZtZtZtZtZtZtZtZtZtZtZtZtZtZtZtZtZtZtZtZtZtZtZtZtZtZtZtZtZtZtZtZtZtZtZtZtZtZtZtZtZtZtZtZtZtZtZtZtZtZtZtZtZtZtZtZtZtZtZtZtZtZtZtZtZtZtZtZtZtZtZtZtZtZtZtZtZtZtZtZtZtZtZtZtZtZtZtZtZtZtZtZtZtZtZt
ZtZtZtZtZtZtZtZtZtZtZtZtZtZtZtZtZtZtZtZtZtZtZtZtZtZtZtZtZtZtZtZtZtZtZtZtZtZtZtZtZtZtZtZtZtZtZtZtZtZtZtZtZtZtZtZtZtZtZtZtZtZtZtZtZtZtZtZtZtZtZtZtZtZtZtZtZtZtZtZtZtZtZtZtZtZtZtZtZtZtZtZtZtZtZtZtZtZtZtZt
ZtZtZtZtZtZtZtZtZtZtZtZtZtZtZtZtZtZtZtZtZtZtZtZtZtZtZtZtZtZtZtZtZtZtZtZtZtZtZtZtZtZtZtZtZtZtZtZtZtZtZtZtZtZtZtZtZtZtZtZtZtZtZtZtZtZtZtZtZtZtZtZtZtZtZtZtZtZtZtZtZtZtZtZtZtZtZtZtZtZtZtZtZtZtZtZtZtZtZtZt
ZtZtZtZtZtZtZtZtZtZtZtZtZtZtZtZtZtZtZtZtZtZtZtZtZtZtZtZtZtZtZtZtZtZtZtZtZtZtZtZtZtZtZtZtZtZtZtZtZtZtZtZtZtZtZtZtZtZtZtZtZtZtZtZtZtZtZtZtZtZtZtZtZtZtZtZtZtZtZtZtZtZtZtZtZtZtZtZtZtZtZtZtZtZtZtZtZtZtZtZt
ZtZtZtZtZtZtZtZtZtZtZtZtZtZtZtZtZtZtZtZtZtZtZtZtZtZtZtZtZtZtZtZtZtZtZtZtZtZtZtZtZtZtZtZtZtZtZtZtZtZtZtZtZtZtZtZtZtZtZtZtZtZtZtZtZtZtZtZtZtZtZtZtZtZtZtZtZtZtZtZtZtZtZtZtZtZtZtZtZtZtZtZtZtZtZtZtZtZtZtZt
ZtZtZtZtZtZtZtZtZtZtZtZtZtZtZtZtZtZtZtZtZtZtZtZtZtZtZtZtZtZtZtZtZtZtZtZtZtZtZtZtZtZtZtZtZtZtZtZtZtZtZtZtZtZtZtZtZtZtZtZtZtZtZtZtZtZtZtZtZtZtZtZtZtZtZtZtZtZtZtZtZtZtZtZtZtZtZtZtZtZtZtZtZtZtZtZtZtZtZtZt
ZtZtZtZtZtZtZtZtZtZtZtZtZtZtZtZtZtZtZtZtZtZtZtZtZtZtZtZtZtZtZtZtZtZtZtZtZtZtZtZtZtZtZtZtZtZtZtZtZtZtZtZtZtZtZtZtZtZtZtZtZtZtZtZtZtZtZtZtZtZtZtZtZtZtZtZtZtZtZtZtZtZtZtZtZtZtZtZtZtZtZtZtZtZtZtZtZtZtZtZt
ZtZtZtZtZtZtZtZtZtZtZtZtZtZtZtZtZtZtZtZtZtZtZtZtZtZtZtZtZtZtZtZtZtZtZtZtZtZtZtZtZtZtZtZtZtZtZtZtZtZtZtZtZtZtZtZtZtZtZtZtZtZtZtZtZtZtZtZtZtZtZtZtZtZtZtZtZtZtZtZtZtZtZtZtZtZtZtZtZtZtZtZtZtZtZtZtZtZtZtZt
ZtZtZtZtZtZtZtZtZtZtZtZtZtZtZtZtZtZtZtZtZtZtZtZtZtZtZtZtZtZtZtZtZtZtZtZtZtZtZtZtZtZtZtZtZtZtZtZtZtZtZtZtZtZtZtZtZtZtZtZtZtZtZtZtZtZtZtZtZtZtZtZtZtZtZtZtZtZtZtZtZtZtZtZtZtZtZtZtZtZtZtZtZtZtZtZtZtZtZtZt
ZtZtZtZtZtZtZtZtZtZtZtZtZtZtZtZtZtZtZtZtZtZtZtZtZtZtZtZtZtZtZtZtZtZtZtZtZtZtZtZtZtZtZtZtZtZtZtZtZtZtZtZtZtZtZtZtZtZtZtZtZtZtZtZtZtZtZtZtZtZtZtZtZtZtZtZtZtZtZtZtZtZtZtZtZtZtZtZtZtZtZtZtZtZtZtZtZtZtZtZt
ZtZtZtZtZtZtZtZtZtZtZtZtZtZtZtZtZtZtZtZtZtZtZtZtZtZtZtZtZtZtZtZtZtZtZtZtZtZtZtZtZtZtZtZtZtZtZtZtZtZtZtZtZtZtZtZtZtZtZtZtZtZtZtZtZtZtZtZtZtZtZtZtZtZtZtZtZtZtZtZtZtZtZtZtZtZtZtZtZtZtZtZtZtZtZtZtZtZtZtZt
ZtZtZtZtZtZtZtZtZtZtZtZtZtZtZtZtZtZtZtZtZtZtZtZtZtZtZtZtZtZtZtZtZtZtZtZtZtZtZtZtZtZtZtZtZtZtZtZtZtZtZtZtZtZtZtZtZtZtZtZtZtZtZtZtZtZtZtZtZtZtZtZtZtZtZtZtZtZtZtZtZtZtZtZtZtZtZtZtZtZtZtZtZtZtZtZtZtZtZtZt
ZtZtZtZtZtZtZtZtZtZtZtZtZtZtZtZtZtZtZtZtZtZtZtZtZtZtZtZtZtZtZtZtZtZtZtZtZtZtZtZtZtZtZtZtZtZtZtZtZtZtZtZtZtZtZtZtZtZtZtZtZtZtZtZtZtZtZtZtZtZtZtZtZtZtZtZtZtZtZtZtZtZtZtZtZtZtZtZtZtZtZtZtZtZtZtZtZtZtZtZt
ZtZtZtZtZtZtZtZtZtZtZtZtZtZtZtZtZtZtZtZtZtZtZtZtZtZtZtZtZtZtZtZtZtZtZtZtZtZtZtZtZtZtZtZtZtZtZtZtZtZtZtZtZtZtZtZtZtZtZtZtZtZtZtZtZtZtZtZtZtZtZtZtZtZtZtZtZtZtZtZtZtZtZtZtZtZtZtZtZtZtZtZtZtZtZtZtZtZtZtZt
ZtZtZtZtZtZtZtZtZtZtZtZtZtZtZtZtZtZtZtZtZtZtZtZtZtZtZtZtZtZtZtZtZtZtZtZtZtZtZtZtZtZtZtZtZtZtZtZtZtZtZtZtZtZtZtZtZtZtZtZtZtZtZtZtZtZtZtZtZtZtZtZtZtZtZtZtZtZtZtZtZtZtZtZtZtZtZtZtZtZtZtZtZtZtZtZtZtZtZtZt
ZtZtZtZtZtZtZtZtZtZtZtZtZtZtZtZtZtZtZtZtZtZtZtZtZtZtZtZtZtZtZtZtZtZtZtZtZtZtZtZtZtZtZtZtZtZtZtZtZtZtZtZtZtZtZtZtZtZtZtZtZtZtZtZtZtZtZtZtZtZtZtZtZtZtZtZtZtZtZtZtZtZtZtZtZtZtZtZtZtZtZtZtZtZtZtZtZtZtZtZt
ZtZtZtZtZtZtZtZtZtZtZtZtZtZtZtZtZtZtZtZtZtZtZtZtZtZtZtZtZtZtZtZtZtZtZtZtZtZtZtZtZtZtZtZtZtZtZtZtZtZtZtZtZtZtZtZtZtZtZtZtZtZtZtZtZtZtZtZtZtZtZtZtZtZtZtZtZtZtZtZtZtZtZtZtZtZtZtZtZtZtZtZtZtZtZtZtZtZtZtZt
ZtZtZtZtZtZtZtZtZtZtZtZtZtZtZtZtZtZtZtZtZtZtZtZtZtZtZtZtZtZtZtZtZtZtZtZtZtZtZtZtZtZtZtZtZtZtZtZtZtZtZtZtZtZtZtZtZtZtZtZtZtZtZtZtZtZtZtZtZtZtZtZtZtZtZtZtZtZtZtZtZtZtZtZtZtZtZtZtZtZtZtZtZtZtZtZtZtZtZtZt
ZtZtZtZtZtZtZtZtZtZtZtZtZtZtZtZtZtZtZtZtZtZtZtZtZtZtZtZtZtZtZtZtZtZtZtZtZtZtZtZtZtZtZtZtZtZtZtZtZtZtZtZtZtZtZtZtZtZtZtZtZtZtZtZtZtZtZtZtZtZtZtZtZtZtZtZtZtZtZtZtZtZtZtZtZtZtZtZtZtZtZtZtZtZtZtZtZtZtZtZt
ZtZtZtZtZtZtZtZtZtZtZtZtZtZtZtZtZtZtZtZtZtZtZtZtZtZtZtZtZtZtZtZtZtZtZtZtZtZtZtZtZtZtZtZtZtZtZtZtZtZtZtZtZtZtZtZtZtZtZtZtZtZtZtZtZtZtZtZtZtZtZtZtZtZtZtZtZtZtZtZtZtZtZtZtZtZtZtZtZtZtZtZtZtZtZtZtZtZtZtZt
ZtZtZtZtZtZtZtZtZtZtZtZtZtZtZtZtZtZtZtZtZtZtZtZtZtZtZtZtZtZtZtZtZtZtZtZtZtZtZtZtZtZtZtZtZtZtZtZtZtZtZtZtZtZtZtZtZtZtZtZtZtZtZtZtZtZtZtZtZtZtZtZtZtZtZtZtZtZtZtZtZtZtZtZtZtZtZtZtZtZtZtZtZtZtZtZtZtZtZtZt
ZtZtZtZtZtZtZtZtZtZtZtZtZtZtZtZtZtZtZtZtZtZtZtZtZtZtZtZtZtZtZtZtZtZtZtZtZtZtZtZtZtZtZtZtZtZtZtZtZtZtZtZtZtZtZtZtZtZtZtZtZtZtZtZtZtZtZtZtZtZtZtZtZtZtZtZtZtZtZtZtZtZtZtZtZtZtZtZtZtZtZtZtZtZtZtZtZtZtZtZt
ZtZtZtZtZtZtZtZtZtZtZtZtZtZtZtZtZtZtZtZtZtZtZtZtZtZtZtZtZtZtZtZtZtZtZtZtZtZtZtZtZtZtZtZtZtZtZtZtZtZtZtZtZtZtZtZtZtZtZtZtZtZtZtZtZtZtZtZtZtZtZtZtZtZtZtZtZtZtZtZtZtZtZtZtZtZtZtZtZtZtZtZtZtZtZtZtZtZtZtZt
ZtZtZtZtZtZtZtZtZtZtZtZtZtZtZtZtZtZtZtZtZtZtZtZtZtZtZtZtZtZtZtZtZtZtZtZtZtZtZtZtZtZtZtZtZtZtZtZtZtZtZtZtZtZtZtZtZtZtZtZtZtZtZtZtZtZtZtZtZtZtZtZtZtZtZtZtZtZtZtZtZtZtZtZtZtZtZtZtZtZtZtZtZtZtZtZtZtZtZtZt
ZtZtZtZtZtZtZtZtZtZtZtZtZtZtZtZtZtZtZtZtZtZtZtZtZtZtZtZtZtZtZtZtZtZtZtZtZtZtZtZtZtZtZtZtZtZtZtZtZtZtZtZtZtZtZtZtZtZtZtZtZtZtZtZtZtZtZtZtZtZtZtZtZtZtZtZtZtZtZtZtZtZtZtZtZtZtZtZtZtZtZtZtZtZtZtZtZtZtZtZt
ZtZtZtZtZtZtZtZtZtZtZtZtZtZtZtZtZtZtZtZtZtZtZtZtZtZtZtZtZtZtZtZtZtZtZtZtZtZtZtZtZtZtZtZtZtZtZtZtZtZtZtZtZtZtZtZtZtZtZtZtZtZtZtZtZtZtZtZtZtZtZtZtZtZtZtZtZtZtZtZtZtZtZtZtZtZtZtZtZtZtZtZtZtZtZtZtZtZtZtZt
ZtZtZtZtZtZtZtZtZtZtZtZtZtZtZtZtZtZtZtZtZtZtZtZtZtZtZtZtZtZtZtZtZtZtZtZtZtZtZtZtZtZtZtZtZtZtZtZtZtZtZtZtZtZtZtZtZtZtZtZtZtZtZtZtZtZtZtZtZtZtZtZtZtZtZtZtZtZtZtZtZtZtZtZtZtZtZtZtZtZtZtZtZtZtZtZtZtZtZtZt
ZtZtZtZtZtZtZtZtZtZtZtZtZtZtZtZtZtZtZtZtZtZtZtZtZtZtZtZtZtZtZtZtZtZtZtZtZtZtZtZtZtZtZtZtZtZtZtZtZtZtZtZtZtZtZtZtZtZtZtZtZtZtZtZtZtZtZtZtZtZtZtZtZtZtZtZtZtZtZtZtZtZtZtZtZtZtZtZtZtZtZtZtZtZtZtZtZtZtZtZt
ZtZtZtZtZtZtZtZtZtZtZtZtZtZtZtZtZtZtZtZtZtZtZtZtZtZtZtZtZtZtZtZtZtZtZtZtZtZtZtZtZtZtZtZtZtZtZtZtZtZtZtZtZtZtZtZtZtZtZtZtZtZtZtZtZtZtZtZtZtZtZtZtZtZtZtZtZtZtZtZtZtZtZtZtZtZtZtZtZtZtZtZtZtZtZtZtZtZtZtZt
ZtZtZtZtZtZtZtZtZtZtZtZtZtZtZtZtZtZtZtZtZtZtZtZtZtZtZtZtZtZtZtZtZtZtZtZtZtZtZtZtZtZtZtZtZtZtZtZtZtZtZtZtZtZtZtZtZtZtZtZtZtZtZtZtZtZtZtZtZtZtZtZtZtZtZtZtZtZtZtZtZtZtZtZtZtZtZtZtZtZtZtZtZtZtZtZtZtZtZtZt
ZtZtZtZtZtZtZtZtZtZtZtZtZtZtZtZtZtZtZtZtZtZtZtZtZtZtZtZtZtZtZtZtZtZtZtZtZtZtZtZtZtZtZtZtZtZtZtZtZtZtZtZtZtZtZtZtZtZtZtZtZtZtZtZtZtZtZtZtZtZtZtZtZtZtZtZtZtZtZtZtZtZtZtZtZtZtZtZtZtZtZtZtZtZtZtZtZtZtZtZt
ZtZtZtZtZtZtZtZtZtZtZtZtZtZtZtZtZtZtZtZtZtZtZtZtZtZtZtZtZtZtZtZtZtZtZtZtZtZtZtZtZtZtZtZtZtZtZtZtZtZtZtZtZtZtZtZtZtZtZtZtZtZtZtZtZtZtZtZtZtZtZtZtZtZtZtZtZtZtZtZtZtZtZtZtZtZtZtZtZtZtZtZtZtZtZtZtZtZtZtZt
ZtZtZtZtZtZtZtZtZtZtZtZtZtZtZtZtZtZtZtZtZtZtZtZtZtZtZtZtZtZtZtZtZtZtZtZtZtZtZtZtZtZtZtZtZtZtZtZtZtZtZtZtZtZtZtZtZtZtZtZtZtZtZtZtZtZtZtZtZtZtZtZtZtZtZtZtZtZtZtZtZtZtZtZtZtZtZtZtZtZtZtZtZtZtZtZtZtZtZtZt
ZtZtZtZtZtZtZtZtZtZtZtZtZtZtZtZtZtZtZtZtZtZtZtZtZtZtZtZtZtZtZtZtZtZtZtZtZtZtZtZtZtZtZtZtZtZtZtZtZtZtZtZtZtZtZtZtZtZtZtZtZtZtZtZtZtZtZtZtZtZtZtZtZtZtZtZtZtZtZtZtZtZtZtZtZtZtZtZtZtZtZtZtZtZtZtZtZtZtZtZt
ZtZtZtZtZtZtZtZtZtZtZtZtZtZtZtZtZtZtZtZtZtZtZtZtZtZtZtZtZtZtZtZtZtZtZtZtZtZtZtZtZtZtZtZtZtZtZtZtZtZtZtZtZtZtZtZtZtZtZtZtZtZtZtZtZtZtZtZtZtZtZtZtZtZtZtZtZtZtZtZtZtZtZtZtZtZtZtZtZtZtZtZtZtZtZtZtZtZtZtZt
ZtZtZtZtZtZtZtZtZtZtZtZtZtZtZtZtZtZtZtZtZtZtZtZtZtZtZtZtZtZtZtZtZtZtZtZtZtZtZtZtZtZtZtZtZtZtZtZtZtZtZtZtZtZtZtZtZtZtZtZtZtZtZtZtZtZtZtZtZtZtZtZtZtZtZtZtZtZtZtZtZtZtZtZtZtZtZtZtZtZtZtZtZtZtZtZtZtZtZtZt
"}
