"aY" = (/obj/structure/torchwall/service{pixel_y = 32},/turf/simulated/open,/area/warfare)
"fs" = (/turf/simulated/floor/plating/n2floor,/area/warfare)
"iw" = (/obj/structure/grille/floorgrille,/turf/simulated/open,/area/warfare)
"mW" = (/obj/structure/torchwall/service{dir = 1},/turf/simulated/open,/area/warfare)
"yn" = (/turf/simulated/wall/concrete,/area/warfare)
"zj" = (/obj/structure/torchwall/service{dir = 8},/obj/effect/floor_decal/turf/plating,/turf/simulated/floor/trenches,/area/warfare)
"zH" = (/turf/simulated/floor/plating/reinforced,/area/warfare)
"Lq" = (/obj/effect/floor_decal/turf/plating,/turf/simulated/floor/trenches,/area/warfare)
"Nn" = (/turf/simulated/floor/trenches,/area/warfare)
"TH" = (/turf/simulated/floor/tiled,/area/warfare)
"Ve" = (/obj/structure/torchwall/service{dir = 4},/obj/effect/floor_decal/turf/plating,/turf/simulated/floor/trenches,/area/warfare)
"Zt" = (/turf/simulated/open,/area/warfare)

(1,1,1) = {"
ZtZtZtZtZtZtZtZtZtZtZtZtZtZtZtZtZtZtZtZtZtZtZtZtZtZtZtZtZtZtZtZtZtZtZtZtZtZtZtZtZtZtZtZtZtZtZtZtZtZtZtZtZtZtZtZtZtZtZtZtZtZtZtZtZtZtZtZtZtZtZtZtZtZtZtZtZtZtZtZtZtZtZtZtZtZtZtZtZtZtZtZtZtZtZtZtZtZtZtZt
ZtZtZtZtZtZtZtZtZtZtZtZtZtZtZtZtZtZtZtZtZtZtZtZtZtZtZtZtZtZtZtZtZtZtZtZtZtZtZtZtZtZtZtZtZtZtZtZtZtZtZtZtZtZtZtZtZtZtZtZtZtZtZtZtZtZtZtZtZtZtZtZtZtZtZtZtZtZtZtZtZtZtZtZtZtZtZtZtZtZtZtZtZtZtZtZtZtZtZtZt
ZtZtZtZtZtZtZtZtZtZtZtZtZtZtZtZtZtZtZtZtZtZtZtZtZtZtZtZtZtZtZtZtZtZtZtZtZtZtZtZtZtZtZtZtZtZtZtZtZtZtZtZtZtZtZtZtZtZtZtZtZtZtZtZtZtZtZtZtZtZtZtZtZtZtZtZtZtZtZtZtZtZtZtZtZtZtZtZtZtZtZtZtZtZtZtZtZtZtZtZt
ZtZtZtZtZtZtZtZtZtZtZtZtZtZtZtZtZtZtZtZtZtZtZtZtZtZtZtZtZtZtZtZtZtZtZtZtZtZtZtZtZtZtZtZtZtZtZtZtZtZtZtZtZtZtZtZtZtZtZtZtZtZtZtZtZtZtZtZtZtZtZtZtZtZtZtZtZtZtZtZtZtZtZtZtZtZtZtZtZtZtZtZtZtZtZtZtZtZtZtZt
ZtZtZtZtZtZtZtZtZtZtZtZtZtZtZtZtZtZtZtZtZtZtZtZtZtZtZtZtZtZtZtZtZtZtZtZtZtZtZtZtZtZtZtZtZtZtZtZtZtZtZtZtZtZtZtZtZtZtZtZtZtZtZtZtZtZtZtZtZtZtZtZtZtZtZtZtZtZtZtZtZtZtZtZtZtZtZtZtZtZtZtZtZtZtZtZtZtZtZtZt
ZtZtZtZtZtZtZtZtZtZtZtZtZtZtZtZtZtZtZtZtZtZtZtZtZtZtZtZtZtZtZtZtZtZtZtZtZtZtZtZtZtZtZtZtZtZtZtZtZtZtZtZtZtZtZtZtZtZtZtZtZtZtZtZtZtZtZtZtZtZtZtZtZtZtZtZtZtZtZtZtZtZtZtZtZtZtZtZtZtZtZtZtZtZtZtZtZtZtZtZt
ZtZtZtZtZtZtZtZtZtZtZtZtZtZtZtZtZtZtZtZtZtZtZtZtZtZtZtZtZtZtZtZtZtZtZtZtZtZtZtZtZtZtZtZtZtZtZtZtZtZtZtZtZtZtZtZtZtZtZtZtZtZtZtZtZtZtZtZtZtZtZtZtZtZtZtZtZtZtZtZtZtZtZtZtZtZtZtZtZtZtZtZtZtZtZtZtZtZtZtZt
ZtZtZtZtZtZtZtZtZtZtZtZtZtZtZtZtZtZtZtZtZtZtZtZtZtZtZtZtZtZtZtZtZtZtZtZtZtZtZtZtZtZtZtZtZtZtZtZtZtZtZtZtZtZtZtZtZtZtZtZtZtZtZtZtZtZtZtZtZtZtZtZtZtZtZtZtZtZtZtZtZtZtZtZtZtZtZtZtZtZtZtZtZtZtZtZtZtZtZtZt
ZtZtZtZtZtZtZtZtZtZtZtZtZtZtZtZtZtZtZtZtZtZtZtZtZtZtZtZtZtZtZtZtZtZtZtZtZtZtZtZtZtZtZtZtZtZtZtZtZtZtZtZtZtZtZtZtZtZtZtZtZtZtZtZtZtZtZtZtZtZtZtZtZtZtZtZtZtZtZtZtZtZtZtZtZtZtZtZtZtZtZtZtZtZtZtZtZtZtZtZt
ZtZtZtZtZtZtZtZtZtZtZtZtZtZtZtZtZtZtZtZtZtZtZtZtZtZtZtZtZtZtZtZtZtZtZtZtZtZtZtZtZtZtZtZtZtZtZtZtZtZtZtZtZtZtZtZtZtZtZtZtZtZtZtZtZtZtZtZtZtZtZtZtZtZtZtZtZtZtZtZtZtZtZtZtZtZtZtZtZtZtZtZtZtZtZtZtZtZtZtZt
ZtZtZtZtZtZtZtZtZtZtZtZtZtZtZtZtZtZtZtZtZtZtZtZtZtZtZtZtZtZtZtZtZtZtZtZtZtZtZtZtZtZtZtZtZtZtZtZtZtZtZtZtZtZtZtZtZtZtZtZtZtZtZtZtZtZtZtZtZtZtZtZtZtZtZtZtZtZtZtZtZtZtZtZtZtZtZtZtZtZtZtZtZtZtZtZtZtZtZtZt
ZtZtZtZtZtZtZtZtZtZtZtZtZtZtZtZtZtZtZtZtZtZtZtZtZtZtZtZtZtZtZtZtZtZtZtZtZtZtZtZtZtZtZtZtZtZtZtZtZtZtZtZtZtZtZtZtZtZtZtZtZtZtZtZtZtZtZtZtZtZtZtZtZtZtZtZtZtZtZtZtZtZtZtZtZtZtZtZtZtZtZtZtZtZtZtZtZtZtZtZt
ZtZtZtZtZtZtZtZtZtZtZtZtZtZtZtZtZtZtZtZtZtZtZtZtZtZtZtZtZtZtZtZtZtZtZtZtZtZtZtZtZtZtZtZtZtZtZtZtZtZtZtZtZtZtZtZtZtZtZtZtZtZtZtZtZtZtZtZtZtZtZtZtZtZtZtZtZtZtZtZtZtZtZtZtZtZtZtZtZtZtZtZtZtZtZtZtZtZtZtZt
ZtZtZtZtZtZtZtZtZtZtZtZtZtZtZtZtZtZtZtZtZtZtZtZtZtZtZtZtZtZtZtZtZtZtZtZtZtZtZtZtZtZtZtZtZtZtZtZtZtZtZtZtZtZtZtZtZtZtZtZtZtZtZtZtZtZtZtZtZtZtZtZtZtZtZtZtZtZtZtZtZtZtZtZtZtZtZtZtZtZtZtZtZtZtZtZtZtZtZtZt
ZtZtZtZtZtZtZtZtZtZtZtZtZtZtZtZtZtZtZtZtZtZtZtZtZtZtZtZtZtZtZtZtZtZtZtZtZtZtZtZtZtZtZtZtZtZtZtZtZtZtZtZtZtZtZtZtZtZtZtZtZtZtZtZtZtZtZtZtZtZtZtZtZtZtZtZtZtZtZtZtZtZtZtZtZtZtZtZtZtZtZtZtZtZtZtZtZtZtZtZt
ZtZtZtZtZtZtZtZtZtZtZtZtZtZtZtZtZtZtZtZtZtZtZtZtZtZtZtZtZtZtZtZtZtZtZtZtZtZtZtZtZtZtZtZtZtZtZtZtZtZtZtZtZtZtZtZtZtZtZtZtZtZtZtZtZtZtZtZtZtZtZtZtZtZtZtZtZtZtZtZtZtZtZtZtZtZtZtZtZtZtZtZtZtZtZtZtZtZtZtZt
ZtZtZtZtZtZtZtZtZtZtZtZtZtZtZtZtZtZtZtZtZtZtZtZtZtZtZtZtZtZtZtZtZtZtZtZtZtZtZtZtZtZtZtZtZtZtZtZtZtZtZtZtZtZtZtZtZtZtZtZtZtZtZtZtZtZtZtZtZtZtZtZtZtZtZtZtZtZtZtZtZtZtZtZtZtZtZtZtZtZtZtZtZtZtZtZtZtZtZtZt
ZtZtZtZtZtZtZtZtZtZtZtZtZtZtZtZtZtZtZtZtZtZtZtZtZtZtZtZtZtZtZtZtZtZtZtZtZtZtZtZtZtZtZtZtZtZtZtZtZtZtZtZtZtZtZtZtZtZtZtZtZtZtZtZtZtZtZtZtZtZtZtZtZtZtZtZtZtZtZtZtZtZtZtZtZtZtZtZtZtZtZtZtZtZtZtZtZtZtZtZt
ZtZtZtZtZtZtZtZtZtZtZtZtZtZtZtZtZtZtZtZtZtZtZtZtZtZtZtZtZtZtZtZtZtZtZtZtZtZtZtZtZtZtZtZtZtZtZtZtZtZtZtZtZtZtZtZtZtZtZtZtZtZtZtZtZtZtZtZtZtZtZtZtZtZtZtZtZtZtZtZtZtZtZtZtZtZtZtZtZtZtZtZtZtZtZtZtZtZtZtZt
ZtZtZtZtZtZtZtZtZtZtZtZtZtZtZtZtZtZtZtZtZtZtZtZtZtZtZtZtZtZtZtZtZtZtZtZtZtZtZtZtZtZtZtZtZtZtZtZtZtZtZtZtZtZtZtZtZtZtZtZtZtZtZtZtZtZtZtZtZtZtZtZtZtZtZtZtZtZtZtZtZtZtZtZtZtZtZtZtZtZtZtZtZtZtZtZtZtZtZtZt
ZtZtZtZtZtZtZtZtZtZtZtZtZtZtZtZtZtZtZtZtZtZtZtZtZtZtZtZtZtZtZtZtZtZtZtZtZtZtZtZtZtZtZtZtZtZtZtZtZtZtZtZtZtZtZtZtZtZtZtZtZtZtZtZtZtZtZtZtZtZtZtZtZtZtZtZtZtZtZtZtZtZtZtZtZtZtZtZtZtZtZtZtZtZtZtZtZtZtZtZt
ZtZtZtZtZtZtZtZtZtZtZtZtZtZtZtZtZtZtZtZtZtZtZtZtZtZtZtZtZtZtZtZtZtZtZtZtZtZtZtZtZtZtZtZtZtZtZtZtZtZtZtZtZtZtZtZtZtZtZtZtZtZtZtZtZtZtZtZtZtZtZtZtZtZtZtZtZtZtZtZtZtZtZtZtZtZtZtZtZtZtZtZtZtZtZtZtZtZtZtZt
ZtZtZtZtZtZtZtZtZtZtZtZtZtZtZtZtZtZtZtZtZtZtZtZtZtZtZtZtZtZtZtZtZtZtZtZtZtZtZtZtZtZtZtZtZtZtZtZtZtZtZtZtZtZtZtZtZtZtZtZtZtZtZtZtZtZtZtZtZtZtZtZtZtZtZtZtZtZtZtZtZtZtZtZtZtZtZtZtZtZtZtZtZtZtZtZtZtZtZtZt
ZtZtZtZtZtZtZtZtZtZtZtZtZtZtZtZtZtZtZtZtZtZtZtZtZtZtZtZtZtZtZtZtZtZtZtZtZtZtZtZtZtZtZtZtZtZtZtZtZtZtZtZtZtZtZtZtZtZtZtZtZtZtZtZtZtZtZtZtZtZtZtZtZtZtZtZtZtZtZtZtZtZtZtZtZtZtZtZtZtZtZtZtZtZtZtZtZtZtZtZt
ZtZtZtZtZtZtZtZtZtZtZtZtZtZtZtZtZtZtZtZtZtZtZtZtZtZtZtZtZtZtZtZtZtZtZtZtZtZtZtZtZtZtZtZtZtZtZtZtZtZtZtZtZtZtZtZtZtZtZtZtZtZtZtZtZtZtZtZtZtZtZtZtZtZtZtZtZtZtZtZtZtZtZtZtZtZtZtZtZtZtZtZtZtZtZtZtZtZtZtZt
ZtZtZtZtZtZtZtZtZtZtZtZtZtZtZtZtZtZtZtZtZtZtZtZtZtZtZtZtZtZtZtZtZtZtZtZtZtZtZtZtZtZtZtZtZtZtZtZtZtZtZtZtZtZtZtZtZtZtZtZtZtZtZtZtZtZtZtZtZtZtZtZtZtZtZtZtZtZtZtZtZtZtZtZtZtZtZtZtZtZtZtZtZtZtZtZtZtZtZtZt
ZtZtZtZtZtZtZtZtZtZtZtZtZtZtZtZtZtZtZtZtZtZtZtZtZtZtZtZtZtZtZtZtZtZtZtZtZtZtZtZtZtZtZtZtZtZtZtZtZtZtZtZtZtZtZtZtZtZtZtZtZtZtZtZtZtZtZtZtZtZtZtZtZtZtZtZtZtZtZtZtZtZtZtZtZtZtZtZtZtZtZtZtZtZtZtZtZtZtZtZt
ZtZtZtZtZtZtZtZtZtZtZtZtZtZtZtZtZtZtZtZtZtZtZtZtZtZtZtZtZtZtZtZtZtZtZtZtZtZtZtZtZtZtZtZtZtZtZtZtZtZtZtZtZtZtZtZtZtZtZtZtZtZtZtZtZtZtZtZtZtZtZtZtZtZtZtZtZtZtZtZtZtZtZtZtZtZtZtZtZtZtZtZtZtZtZtZtZtZtZtZt
ZtZtZtZtZtZtZtZtZtZtZtZtZtZtZtZtZtZtZtZtZtZtZtZtZtZtZtZtZtZtZtZtZtZtZtZtZtZtZtZtZtZtZtZtZtZtZtZtZtZtZtZtZtZtZtZtZtZtZtZtZtZtZtZtZtZtZtZtZtZtZtZtZtZtZtZtZtZtZtZtZtZtZtZtZtZtZtZtZtZtZtZtZtZtZtZtZtZtZtZt
ZtZtZtZtZtZtZtZtZtZtZtZtZtZtZtZtZtZtZtZtZtZtZtZtZtZtZtZtZtZtZtZtZtZtZtZtZtZtZtZtZtZtZtZtZtZtZtZtZtZtZtZtZtZtZtZtZtZtZtZtZtZtZtZtZtZtZtZtZtZtZtZtZtZtZtZtZtZtZtZtZtZtZtZtZtZtZtZtZtZtZtZtZtZtZtZtZtZtZtZt
ZtZtZtZtZtZtZtZtZtZtZtZtZtZtZtZtZtZtZtZtZtZtZtZtZtZtZtZtZtZtZtZtZtZtZtZtZtZtZtZtZtZtZtZtZtZtZtZtZtZtZtZtZtZtZtZtZtZtZtZtZtZtZtZtZtZtZtZtZtZtZtZtZtZtZtZtZtZtZtZtZtZtZtZtZtZtZtZtZtZtZtZtZtZtZtZtZtZtZtZt
ZtZtZtZtZtZtZtZtZtZtZtZtZtZtZtZtZtZtZtZtZtZtZtZtZtZtZtZtZtZtZtZtZtZtZtZtZtZtZtZtZtZtZtZtZtZtZtZtZtZtZtZtZtZtZtZtZtZtZtZtZtZtZtZtZtZtZtZtZtZtZtZtZtZtZtZtZtZtZtZtZtZtZtZtZtZtZtZtZtZtZtZtZtZtZtZtZtZtZtZt
ZtZtZtZtZtZtZtZtZtZtZtZtZtZtZtZtZtZtZtZtZtZtZtZtZtZtZtZtZtZtZtZtZtZtZtZtZtZtZtZtZtZtZtZtZtZtZtZtZtZtZtZtZtZtZtZtZtZtZtZtZtZtZtZtZtZtZtZtZtZtZtZtZtZtZtZtZtZtZtZtZtZtZtZtZtZtZtZtZtZtZtZtZtZtZtZtZtZtZtZt
ZtZtZtZtZtZtZtZtZtZtZtZtZtZtZtZtZtZtZtZtZtZtZtZtZtZtZtZtZtZtZtZtZtZtZtZtZtZtZtZtZtZtZtZtZtZtZtZtZtZtZtZtZtZtZtZtZtZtZtZtZtZtZtZtZtZtZtZtZtZtZtZtZtZtZtZtZtZtZtZtZtZtZtZtZtZtZtZtZtZtZtZtZtZtZtZtZtZtZtZt
ZtZtZtZtZtZtZtZtZtZtZtZtZtZtZtZtZtZtZtZtZtZtZtZtZtZtZtZtZtZtZtZtZtZtZtZtZtZtZtZtZtZtZtZtZtZtZtZtZtZtZtZtZtZtZtZtZtZtZtZtZtZtZtZtZtZtZtZtZtZtZtZtZtZtZtZtZtZtZtZtZtZtZtZtZtZtZtZtZtZtZtZtZtZtZtZtZtZtZtZt
ZtZtZtZtZtZtZtZtZtZtZtZtZtZtZtZtZtZtZtZtZtZtZtZtZtZtZtZtZtZtZtZtZtZtZtZtZtZtZtZtZtZtZtZtZtZtZtZtZtZtZtZtZtZtZtZtZtZtZtZtZtZtZtZtZtZtZtZtZtZtZtZtZtZtZtZtZtZtZtZtZtZtZtZtZtZtZtZtZtZtZtZtZtZtZtZtZtZtZtZt
ZtZtZtZtZtZtZtZtZtZtZtZtZtZtZtZtZtZtZtZtZtZtZtZtZtZtZtZtZtZtZtZtZtZtZtZtZtZtZtZtZtZtZtZtZtZtZtZtZtZtZtZtZtZtZtZtZtZtZtZtZtZtZtZtZtZtZtZtZtZtZtZtZtZtZtZtZtZtZtZtZtZtZtZtZtZtZtZtZtZtZtZtZtZtZtZtZtZtZtZt
ZtZtZtZtZtZtZtZtZtZtZtZtZtZtZtZtZtZtZtZtZtZtZtZtZtZtZtZtZtZtZtZtZtZtZtZtZtZtZtZtZtZtZtZtZtZtZtZtZtZtZtZtZtZtZtZtZtZtZtZtZtZtZtZtZtZtZtZtZtZtZtZtZtZtZtZtZtZtZtZtZtZtZtZtZtZtZtZtZtZtZtZtZtZtZtZtZtZtZtZt
ZtZtZtZtZtZtZtZtZtZtZtZtZtZtZtZtZtZtZtZtZtZtZtZtZtZtZtZtZtZtZtZtZtZtZtZtZtZtZtZtZtZtZtZtZtZtZtTHTHTHTHTHZtZtZtZtZtZtZtZtZtZtZtZtZtZtZtZtZtZtZtZtZtZtZtZtZtZtZtZtZtZtZtZtZtZtZtZtZtZtZtZtZtZtZtZtZtZtZtZt
ZtZtZtZtZtZtZtZtZtZtZtZtZtZtZtZtZtZtZtZtZtZtZtZtZtZtZtZtZtZtZtZtZtZtZtZtZtZtZtZtZtZtZtZtTHTHTHTHTHTHTHTHTHTHTHZtZtZtZtZtZtZtZtZtZtZtZtZtZtZtZtZtZtZtZtZtZtZtZtZtZtZtZtZtZtZtZtZtZtZtZtZtZtZtZtZtZtZtZtZt
ZtZtZtZtZtZtZtZtZtZtZtZtZtZtZtZtZtZtZtZtZtZtZtZtZtZtZtZtZtZtZtZtZtZtZtZtZtZtZtZtZtZtZtZtTHTHTHzHzHzHzHzHTHTHTHZtZtZtZtZtZtZtZtZtZtZtZtZtZtZtZtZtZtZtZtZtZtZtZtZtZtZtZtZtZtZtZtZtZtZtZtZtZtZtZtZtZtZtZtZt
ZtZtZtZtZtZtZtZtZtZtZtZtZtZtZtZtZtZtZtZtZtZtZtZtZtZtZtZtZtZtZtZtZtZtZtZtZtZtZtZtZtZtZtynTHTHTHynNnzHNnynTHTHTHynZtZtZtZtZtZtZtZtZtZtZtZtZtZtZtZtZtZtZtZtZtZtZtZtZtZtZtZtZtZtZtZtZtZtZtZtZtZtZtZtZtZtZtZt
ZtZtZtZtZtZtZtZtZtZtZtZtZtZtZtZtZtZtZtZtZtZtZtZtZtZtZtZtZtZtZtZtZtZtZtZtZtZtZtZtZtZtZtynTHTHTHynNnNnNnynTHTHTHynZtZtZtZtZtZtZtZtZtZtZtZtZtZtZtZtZtZtZtZtZtZtZtZtZtZtZtZtZtZtZtZtZtZtZtZtZtZtZtZtZtZtZtZt
ZtZtZtZtZtZtZtZtZtZtZtZtZtZtZtZtZtZtZtZtZtZtZtZtZtZtZtZtZtZtZtZtZtZtZtZtZtZtZtZtZtZtynynynTHTHynNnNnNnynTHTHynynynZtZtZtZtZtZtZtZtZtZtZtZtZtZtZtZtZtZtZtZtZtZtZtZtZtZtZtZtZtZtZtZtZtZtZtZtZtZtZtZtZtZtZt
ZtZtZtZtZtZtZtZtZtZtZtZtZtZtZtZtZtZtZtZtZtZtZtZtZtZtZtZtZtZtZtZtZtZtZtZtZtZtZtZtZtZtyniwynTHTHynZtZtZtynTHTHyniwynZtZtZtZtZtZtZtZtZtZtZtZtZtZtZtZtZtZtZtZtZtZtZtZtZtZtZtZtZtZtZtZtZtZtZtZtZtZtZtZtZtZtZt
ZtZtZtZtZtZtZtZtZtZtZtZtZtZtZtZtZtZtZtZtZtZtZtZtZtZtZtZtZtZtZtZtZtZtZtZtZtZtZtZtZtZtynfsynynynynZtZtZtynynynynfsynZtZtZtZtZtZtZtZtZtZtZtZtZtZtZtZtZtZtZtZtZtZtZtZtZtZtZtZtZtZtZtZtZtZtZtZtZtZtZtZtZtZtZt
ZtZtZtZtZtZtZtZtZtZtZtZtZtZtZtZtZtZtZtZtZtZtZtZtZtZtZtZtZtZtZtZtZtZtZtZtZtZtZtZtZtZtynfsynynLqLqLqZtLqLqLqynynfsynZtZtZtZtZtZtZtZtZtZtZtZtZtZtZtZtZtZtZtZtZtZtZtZtZtZtZtZtZtZtZtZtZtZtZtZtZtZtZtZtZtZtZt
ZtZtZtZtZtZtZtZtZtZtZtZtZtZtZtZtZtZtZtZtZtZtZtZtZtZtZtZtZtZtZtZtZtZtZtZtZtZtZtZtZtZtynfsynLqLqZtZtZtZtZtLqLqynfsynZtZtZtZtZtZtZtZtZtZtZtZtZtZtZtZtZtZtZtZtZtZtZtZtZtZtZtZtZtZtZtZtZtZtZtZtZtZtZtZtZtZtZt
ZtZtZtZtZtZtZtZtZtZtZtZtZtZtZtZtZtZtZtZtZtZtZtZtZtZtZtZtZtZtZtZtZtZtZtZtZtZtZtZtZtZtynfsynZtZtZtZtmWZtZtZtZtynfsynZtZtZtZtZtZtZtZtZtZtZtZtZtZtZtZtZtZtZtZtZtZtZtZtZtZtZtZtZtZtZtZtZtZtZtZtZtZtZtZtZtZtZt
ZtZtZtZtZtZtZtZtZtZtZtZtZtZtZtZtZtZtZtZtZtZtZtZtZtZtZtZtZtZtZtZtZtZtZtZtZtZtZtZtZtynynfsynVeZtZtLqynLqZtZtynynfsynynZtZtZtZtZtZtZtZtZtZtZtZtZtZtZtZtZtZtZtZtZtZtZtZtZtZtZtZtZtZtZtZtZtZtZtZtZtZtZtZtZtZt
ZtZtZtZtZtZtZtZtZtZtZtZtZtZtZtZtZtZtZtZtZtZtZtZtZtZtZtZtZtZtZtZtZtZtZtZtZtZtZtZtZtyniwfsfsLqZtZtZtynZtZtZtLqfsfsiwynZtZtZtZtZtZtZtZtZtZtZtZtZtZtZtZtZtZtZtZtZtZtZtZtZtZtZtZtZtZtZtZtZtZtZtZtZtZtZtZtZtZt
ZtZtZtZtZtZtZtZtZtZtZtZtZtZtZtZtZtZtZtZtZtZtZtZtZtZtZtZtZtZtZtZtZtZtZtZtZtZtZtZtZtynynfsynynZtZtLqynLqZtZtzjynfsynynZtZtZtZtZtZtZtZtZtZtZtZtZtZtZtZtZtZtZtZtZtZtZtZtZtZtZtZtZtZtZtZtZtZtZtZtZtZtZtZtZtZt
ZtZtZtZtZtZtZtZtZtZtZtZtZtZtZtZtZtZtZtZtZtZtZtZtZtZtZtZtZtZtZtZtZtZtZtZtZtZtZtZtZtZtynfsynZtZtZtZtaYZtZtZtZtynfsynZtZtZtZtZtZtZtZtZtZtZtZtZtZtZtZtZtZtZtZtZtZtZtZtZtZtZtZtZtZtZtZtZtZtZtZtZtZtZtZtZtZtZt
ZtZtZtZtZtZtZtZtZtZtZtZtZtZtZtZtZtZtZtZtZtZtZtZtZtZtZtZtZtZtZtZtZtZtZtZtZtZtZtZtZtZtynfsynLqLqZtZtZtZtZtLqLqynfsynZtZtZtZtZtZtZtZtZtZtZtZtZtZtZtZtZtZtZtZtZtZtZtZtZtZtZtZtZtZtZtZtZtZtZtZtZtZtZtZtZtZtZt
ZtZtZtZtZtZtZtZtZtZtZtZtZtZtZtZtZtZtZtZtZtZtZtZtZtZtZtZtZtZtZtZtZtZtZtZtZtZtZtZtZtZtynfsynynLqLqLqZtLqLqLqynynfsynZtZtZtZtZtZtZtZtZtZtZtZtZtZtZtZtZtZtZtZtZtZtZtZtZtZtZtZtZtZtZtZtZtZtZtZtZtZtZtZtZtZtZt
ZtZtZtZtZtZtZtZtZtZtZtZtZtZtZtZtZtZtZtZtZtZtZtZtZtZtZtZtZtZtZtZtZtZtZtZtZtZtZtZtZtZtynfsynynynynZtZtZtynynynynfsynZtZtZtZtZtZtZtZtZtZtZtZtZtZtZtZtZtZtZtZtZtZtZtZtZtZtZtZtZtZtZtZtZtZtZtZtZtZtZtZtZtZtZt
ZtZtZtZtZtZtZtZtZtZtZtZtZtZtZtZtZtZtZtZtZtZtZtZtZtZtZtZtZtZtZtZtZtZtZtZtZtZtZtZtZtZtyniwynTHTHynZtZtZtynTHTHyniwynZtZtZtZtZtZtZtZtZtZtZtZtZtZtZtZtZtZtZtZtZtZtZtZtZtZtZtZtZtZtZtZtZtZtZtZtZtZtZtZtZtZtZt
ZtZtZtZtZtZtZtZtZtZtZtZtZtZtZtZtZtZtZtZtZtZtZtZtZtZtZtZtZtZtZtZtZtZtZtZtZtZtZtZtZtZtynynynTHTHynNnNnNnynTHTHynynynZtZtZtZtZtZtZtZtZtZtZtZtZtZtZtZtZtZtZtZtZtZtZtZtZtZtZtZtZtZtZtZtZtZtZtZtZtZtZtZtZtZtZt
ZtZtZtZtZtZtZtZtZtZtZtZtZtZtZtZtZtZtZtZtZtZtZtZtZtZtZtZtZtZtZtZtZtZtZtZtZtZtZtZtZtZtZtynTHTHTHynNnNnNnynTHTHTHynZtZtZtZtZtZtZtZtZtZtZtZtZtZtZtZtZtZtZtZtZtZtZtZtZtZtZtZtZtZtZtZtZtZtZtZtZtZtZtZtZtZtZtZt
ZtZtZtZtZtZtZtZtZtZtZtZtZtZtZtZtZtZtZtZtZtZtZtZtZtZtZtZtZtZtZtZtZtZtZtZtZtZtZtZtZtZtZtynTHTHTHynNnzHNnynTHTHTHynZtZtZtZtZtZtZtZtZtZtZtZtZtZtZtZtZtZtZtZtZtZtZtZtZtZtZtZtZtZtZtZtZtZtZtZtZtZtZtZtZtZtZtZt
ZtZtZtZtZtZtZtZtZtZtZtZtZtZtZtZtZtZtZtZtZtZtZtZtZtZtZtZtZtZtZtZtZtZtZtZtZtZtZtZtZtZtZtZtTHTHzHzHzHzHzHzHzHTHTHZtZtZtZtZtZtZtZtZtZtZtZtZtZtZtZtZtZtZtZtZtZtZtZtZtZtZtZtZtZtZtZtZtZtZtZtZtZtZtZtZtZtZtZtZt
ZtZtZtZtZtZtZtZtZtZtZtZtZtZtZtZtZtZtZtZtZtZtZtZtZtZtZtZtZtZtZtZtZtZtZtZtZtZtZtZtZtZtZtZtTHTHTHTHzHTHTHTHzHTHTHZtZtZtZtZtZtZtZtZtZtZtZtZtZtZtZtZtZtZtZtZtZtZtZtZtZtZtZtZtZtZtZtZtZtZtZtZtZtZtZtZtZtZtZtZt
ZtZtZtZtZtZtZtZtZtZtZtZtZtZtZtZtZtZtZtZtZtZtZtZtZtZtZtZtZtZtZtZtZtZtZtZtZtZtZtZtZtZtZtZtZtZtZtZtZtZtZtZtZtZtZtZtZtZtZtZtZtZtZtZtZtZtZtZtZtZtZtZtZtZtZtZtZtZtZtZtZtZtZtZtZtZtZtZtZtZtZtZtZtZtZtZtZtZtZtZt
ZtZtZtZtZtZtZtZtZtZtZtZtZtZtZtZtZtZtZtZtZtZtZtZtZtZtZtZtZtZtZtZtZtZtZtZtZtZtZtZtZtZtZtZtZtZtZtZtZtZtZtZtZtZtZtZtZtZtZtZtZtZtZtZtZtZtZtZtZtZtZtZtZtZtZtZtZtZtZtZtZtZtZtZtZtZtZtZtZtZtZtZtZtZtZtZtZtZtZtZt
ZtZtZtZtZtZtZtZtZtZtZtZtZtZtZtZtZtZtZtZtZtZtZtZtZtZtZtZtZtZtZtZtZtZtZtZtZtZtZtZtZtZtZtZtZtZtZtZtZtZtZtZtZtZtZtZtZtZtZtZtZtZtZtZtZtZtZtZtZtZtZtZtZtZtZtZtZtZtZtZtZtZtZtZtZtZtZtZtZtZtZtZtZtZtZtZtZtZtZtZt
ZtZtZtZtZtZtZtZtZtZtZtZtZtZtZtZtZtZtZtZtZtZtZtZtZtZtZtZtZtZtZtZtZtZtZtZtZtZtZtZtZtZtZtZtZtZtZtZtZtZtZtZtZtZtZtZtZtZtZtZtZtZtZtZtZtZtZtZtZtZtZtZtZtZtZtZtZtZtZtZtZtZtZtZtZtZtZtZtZtZtZtZtZtZtZtZtZtZtZtZt
ZtZtZtZtZtZtZtZtZtZtZtZtZtZtZtZtZtZtZtZtZtZtZtZtZtZtZtZtZtZtZtZtZtZtZtZtZtZtZtZtZtZtZtZtZtZtZtZtZtZtZtZtZtZtZtZtZtZtZtZtZtZtZtZtZtZtZtZtZtZtZtZtZtZtZtZtZtZtZtZtZtZtZtZtZtZtZtZtZtZtZtZtZtZtZtZtZtZtZtZt
ZtZtZtZtZtZtZtZtZtZtZtZtZtZtZtZtZtZtZtZtZtZtZtZtZtZtZtZtZtZtZtZtZtZtZtZtZtZtZtZtZtZtZtZtZtZtZtZtZtZtZtZtZtZtZtZtZtZtZtZtZtZtZtZtZtZtZtZtZtZtZtZtZtZtZtZtZtZtZtZtZtZtZtZtZtZtZtZtZtZtZtZtZtZtZtZtZtZtZtZt
ZtZtZtZtZtZtZtZtZtZtZtZtZtZtZtZtZtZtZtZtZtZtZtZtZtZtZtZtZtZtZtZtZtZtZtZtZtZtZtZtZtZtZtZtZtZtZtZtZtZtZtZtZtZtZtZtZtZtZtZtZtZtZtZtZtZtZtZtZtZtZtZtZtZtZtZtZtZtZtZtZtZtZtZtZtZtZtZtZtZtZtZtZtZtZtZtZtZtZtZt
ZtZtZtZtZtZtZtZtZtZtZtZtZtZtZtZtZtZtZtZtZtZtZtZtZtZtZtZtZtZtZtZtZtZtZtZtZtZtZtZtZtZtZtZtZtZtZtZtZtZtZtZtZtZtZtZtZtZtZtZtZtZtZtZtZtZtZtZtZtZtZtZtZtZtZtZtZtZtZtZtZtZtZtZtZtZtZtZtZtZtZtZtZtZtZtZtZtZtZtZt
ZtZtZtZtZtZtZtZtZtZtZtZtZtZtZtZtZtZtZtZtZtZtZtZtZtZtZtZtZtZtZtZtZtZtZtZtZtZtZtZtZtZtZtZtZtZtZtZtZtZtZtZtZtZtZtZtZtZtZtZtZtZtZtZtZtZtZtZtZtZtZtZtZtZtZtZtZtZtZtZtZtZtZtZtZtZtZtZtZtZtZtZtZtZtZtZtZtZtZtZt
ZtZtZtZtZtZtZtZtZtZtZtZtZtZtZtZtZtZtZtZtZtZtZtZtZtZtZtZtZtZtZtZtZtZtZtZtZtZtZtZtZtZtZtZtZtZtZtZtZtZtZtZtZtZtZtZtZtZtZtZtZtZtZtZtZtZtZtZtZtZtZtZtZtZtZtZtZtZtZtZtZtZtZtZtZtZtZtZtZtZtZtZtZtZtZtZtZtZtZtZt
ZtZtZtZtZtZtZtZtZtZtZtZtZtZtZtZtZtZtZtZtZtZtZtZtZtZtZtZtZtZtZtZtZtZtZtZtZtZtZtZtZtZtZtZtZtZtZtZtZtZtZtZtZtZtZtZtZtZtZtZtZtZtZtZtZtZtZtZtZtZtZtZtZtZtZtZtZtZtZtZtZtZtZtZtZtZtZtZtZtZtZtZtZtZtZtZtZtZtZtZt
ZtZtZtZtZtZtZtZtZtZtZtZtZtZtZtZtZtZtZtZtZtZtZtZtZtZtZtZtZtZtZtZtZtZtZtZtZtZtZtZtZtZtZtZtZtZtZtZtZtZtZtZtZtZtZtZtZtZtZtZtZtZtZtZtZtZtZtZtZtZtZtZtZtZtZtZtZtZtZtZtZtZtZtZtZtZtZtZtZtZtZtZtZtZtZtZtZtZtZtZt
ZtZtZtZtZtZtZtZtZtZtZtZtZtZtZtZtZtZtZtZtZtZtZtZtZtZtZtZtZtZtZtZtZtZtZtZtZtZtZtZtZtZtZtZtZtZtZtZtZtZtZtZtZtZtZtZtZtZtZtZtZtZtZtZtZtZtZtZtZtZtZtZtZtZtZtZtZtZtZtZtZtZtZtZtZtZtZtZtZtZtZtZtZtZtZtZtZtZtZtZt
ZtZtZtZtZtZtZtZtZtZtZtZtZtZtZtZtZtZtZtZtZtZtZtZtZtZtZtZtZtZtZtZtZtZtZtZtZtZtZtZtZtZtZtZtZtZtZtZtZtZtZtZtZtZtZtZtZtZtZtZtZtZtZtZtZtZtZtZtZtZtZtZtZtZtZtZtZtZtZtZtZtZtZtZtZtZtZtZtZtZtZtZtZtZtZtZtZtZtZtZt
ZtZtZtZtZtZtZtZtZtZtZtZtZtZtZtZtZtZtZtZtZtZtZtZtZtZtZtZtZtZtZtZtZtZtZtZtZtZtZtZtZtZtZtZtZtZtZtZtZtZtZtZtZtZtZtZtZtZtZtZtZtZtZtZtZtZtZtZtZtZtZtZtZtZtZtZtZtZtZtZtZtZtZtZtZtZtZtZtZtZtZtZtZtZtZtZtZtZtZtZt
ZtZtZtZtZtZtZtZtZtZtZtZtZtZtZtZtZtZtZtZtZtZtZtZtZtZtZtZtZtZtZtZtZtZtZtZtZtZtZtZtZtZtZtZtZtZtZtZtZtZtZtZtZtZtZtZtZtZtZtZtZtZtZtZtZtZtZtZtZtZtZtZtZtZtZtZtZtZtZtZtZtZtZtZtZtZtZtZtZtZtZtZtZtZtZtZtZtZtZtZt
ZtZtZtZtZtZtZtZtZtZtZtZtZtZtZtZtZtZtZtZtZtZtZtZtZtZtZtZtZtZtZtZtZtZtZtZtZtZtZtZtZtZtZtZtZtZtZtZtZtZtZtZtZtZtZtZtZtZtZtZtZtZtZtZtZtZtZtZtZtZtZtZtZtZtZtZtZtZtZtZtZtZtZtZtZtZtZtZtZtZtZtZtZtZtZtZtZtZtZtZt
ZtZtZtZtZtZtZtZtZtZtZtZtZtZtZtZtZtZtZtZtZtZtZtZtZtZtZtZtZtZtZtZtZtZtZtZtZtZtZtZtZtZtZtZtZtZtZtZtZtZtZtZtZtZtZtZtZtZtZtZtZtZtZtZtZtZtZtZtZtZtZtZtZtZtZtZtZtZtZtZtZtZtZtZtZtZtZtZtZtZtZtZtZtZtZtZtZtZtZtZt
ZtZtZtZtZtZtZtZtZtZtZtZtZtZtZtZtZtZtZtZtZtZtZtZtZtZtZtZtZtZtZtZtZtZtZtZtZtZtZtZtZtZtZtZtZtZtZtZtZtZtZtZtZtZtZtZtZtZtZtZtZtZtZtZtZtZtZtZtZtZtZtZtZtZtZtZtZtZtZtZtZtZtZtZtZtZtZtZtZtZtZtZtZtZtZtZtZtZtZtZt
ZtZtZtZtZtZtZtZtZtZtZtZtZtZtZtZtZtZtZtZtZtZtZtZtZtZtZtZtZtZtZtZtZtZtZtZtZtZtZtZtZtZtZtZtZtZtZtZtZtZtZtZtZtZtZtZtZtZtZtZtZtZtZtZtZtZtZtZtZtZtZtZtZtZtZtZtZtZtZtZtZtZtZtZtZtZtZtZtZtZtZtZtZtZtZtZtZtZtZtZt
ZtZtZtZtZtZtZtZtZtZtZtZtZtZtZtZtZtZtZtZtZtZtZtZtZtZtZtZtZtZtZtZtZtZtZtZtZtZtZtZtZtZtZtZtZtZtZtZtZtZtZtZtZtZtZtZtZtZtZtZtZtZtZtZtZtZtZtZtZtZtZtZtZtZtZtZtZtZtZtZtZtZtZtZtZtZtZtZtZtZtZtZtZtZtZtZtZtZtZtZt
ZtZtZtZtZtZtZtZtZtZtZtZtZtZtZtZtZtZtZtZtZtZtZtZtZtZtZtZtZtZtZtZtZtZtZtZtZtZtZtZtZtZtZtZtZtZtZtZtZtZtZtZtZtZtZtZtZtZtZtZtZtZtZtZtZtZtZtZtZtZtZtZtZtZtZtZtZtZtZtZtZtZtZtZtZtZtZtZtZtZtZtZtZtZtZtZtZtZtZtZt
ZtZtZtZtZtZtZtZtZtZtZtZtZtZtZtZtZtZtZtZtZtZtZtZtZtZtZtZtZtZtZtZtZtZtZtZtZtZtZtZtZtZtZtZtZtZtZtZtZtZtZtZtZtZtZtZtZtZtZtZtZtZtZtZtZtZtZtZtZtZtZtZtZtZtZtZtZtZtZtZtZtZtZtZtZtZtZtZtZtZtZtZtZtZtZtZtZtZtZtZt
ZtZtZtZtZtZtZtZtZtZtZtZtZtZtZtZtZtZtZtZtZtZtZtZtZtZtZtZtZtZtZtZtZtZtZtZtZtZtZtZtZtZtZtZtZtZtZtZtZtZtZtZtZtZtZtZtZtZtZtZtZtZtZtZtZtZtZtZtZtZtZtZtZtZtZtZtZtZtZtZtZtZtZtZtZtZtZtZtZtZtZtZtZtZtZtZtZtZtZtZt
ZtZtZtZtZtZtZtZtZtZtZtZtZtZtZtZtZtZtZtZtZtZtZtZtZtZtZtZtZtZtZtZtZtZtZtZtZtZtZtZtZtZtZtZtZtZtZtZtZtZtZtZtZtZtZtZtZtZtZtZtZtZtZtZtZtZtZtZtZtZtZtZtZtZtZtZtZtZtZtZtZtZtZtZtZtZtZtZtZtZtZtZtZtZtZtZtZtZtZtZt
ZtZtZtZtZtZtZtZtZtZtZtZtZtZtZtZtZtZtZtZtZtZtZtZtZtZtZtZtZtZtZtZtZtZtZtZtZtZtZtZtZtZtZtZtZtZtZtZtZtZtZtZtZtZtZtZtZtZtZtZtZtZtZtZtZtZtZtZtZtZtZtZtZtZtZtZtZtZtZtZtZtZtZtZtZtZtZtZtZtZtZtZtZtZtZtZtZtZtZtZt
ZtZtZtZtZtZtZtZtZtZtZtZtZtZtZtZtZtZtZtZtZtZtZtZtZtZtZtZtZtZtZtZtZtZtZtZtZtZtZtZtZtZtZtZtZtZtZtZtZtZtZtZtZtZtZtZtZtZtZtZtZtZtZtZtZtZtZtZtZtZtZtZtZtZtZtZtZtZtZtZtZtZtZtZtZtZtZtZtZtZtZtZtZtZtZtZtZtZtZtZt
ZtZtZtZtZtZtZtZtZtZtZtZtZtZtZtZtZtZtZtZtZtZtZtZtZtZtZtZtZtZtZtZtZtZtZtZtZtZtZtZtZtZtZtZtZtZtZtZtZtZtZtZtZtZtZtZtZtZtZtZtZtZtZtZtZtZtZtZtZtZtZtZtZtZtZtZtZtZtZtZtZtZtZtZtZtZtZtZtZtZtZtZtZtZtZtZtZtZtZtZt
ZtZtZtZtZtZtZtZtZtZtZtZtZtZtZtZtZtZtZtZtZtZtZtZtZtZtZtZtZtZtZtZtZtZtZtZtZtZtZtZtZtZtZtZtZtZtZtZtZtZtZtZtZtZtZtZtZtZtZtZtZtZtZtZtZtZtZtZtZtZtZtZtZtZtZtZtZtZtZtZtZtZtZtZtZtZtZtZtZtZtZtZtZtZtZtZtZtZtZtZt
ZtZtZtZtZtZtZtZtZtZtZtZtZtZtZtZtZtZtZtZtZtZtZtZtZtZtZtZtZtZtZtZtZtZtZtZtZtZtZtZtZtZtZtZtZtZtZtZtZtZtZtZtZtZtZtZtZtZtZtZtZtZtZtZtZtZtZtZtZtZtZtZtZtZtZtZtZtZtZtZtZtZtZtZtZtZtZtZtZtZtZtZtZtZtZtZtZtZtZtZt
ZtZtZtZtZtZtZtZtZtZtZtZtZtZtZtZtZtZtZtZtZtZtZtZtZtZtZtZtZtZtZtZtZtZtZtZtZtZtZtZtZtZtZtZtZtZtZtZtZtZtZtZtZtZtZtZtZtZtZtZtZtZtZtZtZtZtZtZtZtZtZtZtZtZtZtZtZtZtZtZtZtZtZtZtZtZtZtZtZtZtZtZtZtZtZtZtZtZtZtZt
ZtZtZtZtZtZtZtZtZtZtZtZtZtZtZtZtZtZtZtZtZtZtZtZtZtZtZtZtZtZtZtZtZtZtZtZtZtZtZtZtZtZtZtZtZtZtZtZtZtZtZtZtZtZtZtZtZtZtZtZtZtZtZtZtZtZtZtZtZtZtZtZtZtZtZtZtZtZtZtZtZtZtZtZtZtZtZtZtZtZtZtZtZtZtZtZtZtZtZtZt
ZtZtZtZtZtZtZtZtZtZtZtZtZtZtZtZtZtZtZtZtZtZtZtZtZtZtZtZtZtZtZtZtZtZtZtZtZtZtZtZtZtZtZtZtZtZtZtZtZtZtZtZtZtZtZtZtZtZtZtZtZtZtZtZtZtZtZtZtZtZtZtZtZtZtZtZtZtZtZtZtZtZtZtZtZtZtZtZtZtZtZtZtZtZtZtZtZtZtZtZt
ZtZtZtZtZtZtZtZtZtZtZtZtZtZtZtZtZtZtZtZtZtZtZtZtZtZtZtZtZtZtZtZtZtZtZtZtZtZtZtZtZtZtZtZtZtZtZtZtZtZtZtZtZtZtZtZtZtZtZtZtZtZtZtZtZtZtZtZtZtZtZtZtZtZtZtZtZtZtZtZtZtZtZtZtZtZtZtZtZtZtZtZtZtZtZtZtZtZtZtZt
ZtZtZtZtZtZtZtZtZtZtZtZtZtZtZtZtZtZtZtZtZtZtZtZtZtZtZtZtZtZtZtZtZtZtZtZtZtZtZtZtZtZtZtZtZtZtZtZtZtZtZtZtZtZtZtZtZtZtZtZtZtZtZtZtZtZtZtZtZtZtZtZtZtZtZtZtZtZtZtZtZtZtZtZtZtZtZtZtZtZtZtZtZtZtZtZtZtZtZtZt
ZtZtZtZtZtZtZtZtZtZtZtZtZtZtZtZtZtZtZtZtZtZtZtZtZtZtZtZtZtZtZtZtZtZtZtZtZtZtZtZtZtZtZtZtZtZtZtZtZtZtZtZtZtZtZtZtZtZtZtZtZtZtZtZtZtZtZtZtZtZtZtZtZtZtZtZtZtZtZtZtZtZtZtZtZtZtZtZtZtZtZtZtZtZtZtZtZtZtZtZt
ZtZtZtZtZtZtZtZtZtZtZtZtZtZtZtZtZtZtZtZtZtZtZtZtZtZtZtZtZtZtZtZtZtZtZtZtZtZtZtZtZtZtZtZtZtZtZtZtZtZtZtZtZtZtZtZtZtZtZtZtZtZtZtZtZtZtZtZtZtZtZtZtZtZtZtZtZtZtZtZtZtZtZtZtZtZtZtZtZtZtZtZtZtZtZtZtZtZtZtZt
ZtZtZtZtZtZtZtZtZtZtZtZtZtZtZtZtZtZtZtZtZtZtZtZtZtZtZtZtZtZtZtZtZtZtZtZtZtZtZtZtZtZtZtZtZtZtZtZtZtZtZtZtZtZtZtZtZtZtZtZtZtZtZtZtZtZtZtZtZtZtZtZtZtZtZtZtZtZtZtZtZtZtZtZtZtZtZtZtZtZtZtZtZtZtZtZtZtZtZtZt
"}
